S----SSSSSSSSSSSSSSSSSSSSSSSSSSSSSSSSSSSSSSSSSSSSSSSSSSSSSSSSSSSSSSSSSSSSSSSSSSSSSSSSSSSSSSSSSSSSSSSSSSSSSSSSSSSSSSSSSSSSSSSSSSSSSSSSSSSSSSSSSSSSSSSSS
S----SSSSSSSSSSSSSSSSSSSSSSSSSSSSSSSSSSSSSSS-----SSSSSSSSSSSSSSSSSSSSSSSSSSS-------SSSSSSSSSSSSSSSSSSSSSSSSSSSSSSSSSSSSSSSSSSSSSSSSSSSSSSSSSSSSSSSSSSS
S---------SSSSSSSSSSSSSSSSSS---------------------SSSSSSSSSSSSSSSSSSSSSSSSSSS-------SSSSSSSS-----SSSSS----------------SSSSSSSS-------SSSSSSSSSSSSSSSSSS
S---------SSSSSSSSSS-----------------------------SSSSSS-----------------------------------------SSSSS----------------SSSSSSSS-------SSSSSSSS------SSSS
S-----------------------------------------------------------------------------------------------------------------------------------------------------
S-----------------------------------------------------------------------------------------------------------------------------------------------------
S-----------------------------------------------------------------------------------------------------------------------------------------------------
S-----------------------------------------------------------------------------------------------------------------------------------------------------
S---------------------------------------------------------------------------------------------------------------ooSoSoo-------------------------oooo--
S----------------SoooSo---oSoo-----------------------------SSoo----------------------------------ooS--------------------------------------------------
S----------------------------------ooooS-----------------------------------------------oooo-----------------------oooo----ooooo-----------------oooo--
S-----------------ooooo------oooo-----------------------oooooo----------------------------r-----oooo------------rk-----------g------oSooo-------------
S-------------------------rk-k--y-----oooo--XXXX------------g-----------------r------XXXXXXX------------ooooo--XXXXXXXXXXXXXXXXXXXX---------XXXXXXXXXX
SXXXXXXXXX-----XXXXXXXXXXXXXXXXXXX----------XXXXXXXXXXXXXXXXXXXXX-------yg---XXXXXXXXXXXXXXXXXXXXXXXXXX---y----XXXXXXXXXXXXXXXXXXXX--oooo---XXXXXXXXXX
SXXXXXXXXX-----XXXXXXXXXXXXXXXXXXXXXXXXXXXXXXXXXXXXXXXXXXXXXXXXXX-----XXXXXXXXXXXXXXXXXXXXXXXXXXXXXXXXXXXXXXXXXXXXXXXXXXXXXXXXXXXXX---------XXXXXXXXXX
SXXXXXXXXXXXXXXXXXXXXXXXXXXXXXXXXXXXXXXXXXXXXXXXXXXXXXXXXXXXXXXXXXXXXXXXXXXXXXXXXXXXXXXXXXXXXXXXXXXXXXXXXXXXXXXXXXXXXXXXXXXXXXXXXXXXXXXXXXXXXXXXXXXXXX
