S----SSSSSSSSSSSSSSSSSSSSSSSSSSSSSSSSSSSSSSSSSSSSSSSSSSSSSSSSSSSSSSSSSSSSSSSSSSSSSSSSSSSSSSSSSSSSSSSSSSSSSSSSSSSSSSSSSSSSSSSSSSSSSSSSSSSSSSSSSSSSSSSSS
S------------SSSSSSSSSSSSSS----------SSSSS--------SSSSSS-----SSSSSSSSSSSSSSSSSSSSSSSSSSSSSSSS-----------SSSSSSSSSSSSSSSSSSSSSSSSSSSSSSSSSSSSSSS-------
S------------SSSSSSSSSSSSSS----------------------------------SSSSSSS------SSSSSSSSSSSSSSSSSSS-----------SSSSSSSSSSSSSSSSSSSSSSSSSSSSSSSSSSSSSSS-------
S------------SSSSSSS-----------------------------------------SSSSSSS------SSSSS--------SSSSSS-----------SSSSSSSSSSSSSSSSSSSSSSSSSSSS------------------
S-----------------------------------------------------------------------------------------------------------------------------------------------------
S-----------------------------------------------------------------------------------------------------------------------------------------------------
S-----------------------------------------------------------------------------------------------------------------------------------------------------
S-----------------------------------------------------------------------------------------------------------------------------------------------------
S-------------------------------------------oooooSoSo-------------------------------------------------------------------------------------------------
S----------------oSS----------------------------------------------------------------------------------------------------------------------------------
S-------------------------------------------oooooooo----ooSooo------------------------------------oooSSoo---------------------------------------------
S------------------oo-----------------------r------------------------------------SoooS-----------------------------------oo---oSooooo-----------oo----
S----------------k-------------------------XXXXXXXXXXX--oooo--------------------------------XXXX----ooo-------------------g------------XX------r------
SXXXXXXXXXXXX---XXXXXXX-ooo-------XXXXXXXXXXXXXXXXXXXX--r-----------------------ooooooooo-XXXXXX----k-----------------XXXXXX----ooooo--XXXXXXXXXXXXXX-
SXXXXXXXXXXXXXXXXXXXXXX--g-g------XXXXXXXXXXXXXXXXXXXXXXXXXXXXXX--------XXXXXXX------k--r-XXXXXXXXXXXXXXXXX--XXXXX----XXXXXX-r---------XXXXXXXXXXXXXX-
SXXXXXXXXXXXXXXXXXXXXXXXXXXXXXXXXXXXXXXXXXXXXXXXXXXXXXXXXXXXXXXXXXXXXXXXXXXXXXXXXXXXXXXXXXXXXXXXXXXXXXXXXXXXXXXXXXXXXXXXXXXXXXXXXXXXXXXXXXXXXXXXXXXXXX
