S----SSSSSSSSSSSSSSSSSSSSSSSSSSSSSSSSSSSSSSSSSSSSSSSSSSSSSSSSSSSSSSSSSSSSSSSSSSSSSSSSSSSSSSSSSSSSSSSSSSSSSSSSSSSSSSSSSSSSSSSSSSSSSSSSSSSSSSSSSSSSSSSSS
S------------SSSSS----------------------SSSSSSSSSS-------------SSSSSSSS------SSSSS-----SSSSSSSS--------SSSSSSSSSSSSSSSSSSSSSSSSS---------------SSSSSSS
S------------SSSSS----------------------SSSSS------------------SSSSSSSS------SSSSS---------------------SSSSSSSSSSSS----------------------------SSSSSSS
S------------SSSSS----------------------SSSSS------------------SSSSSSSS--------------------------------SSSSS-----------------------------------SSSSSS-
S-----------------------------------------------------------------------------------------------------------------------------------------------------
S-----------------------------------------------------------------------------------------------------------------------------------------------------
S-----------------------------------------------------------------------------------------------------------------------------------------------------
S-----------------------------------------------------------------------------------------------------------------------------------------------------
S----------------------------------SoSSoS---------------------------------ooooooo---------------------------------------------------------------------
S----------------------------------------------------------------------------------------------------Soooo--------------------------------------------
S------------ooooSoo--------------oooooo----------SoSS---------------------oooo--------------------------------------------------------oooo-----------
S------------------------oo-------r-------------------------oooo--------------------------------------oooo-----------------------------r--r-----------
S-------------oooo------r-g------XXXXXXXXXXXXXXX-oooooooo--y-----k-------XXXXXXXXXX-----XXXX--XXXX-g---------------------XXXX---------XXXXXXXXXXX-----
S---------------------XXXXXX-----XXXXXXXXXXXXXXX------gg--XXXXXXXXXX-----XXXXXXXXXX-----XXXX--XXXXXXXXXXXXXXX-------oo---XXXX----XXXXXXXXXXXXXXXX-----
S-----------XXXXXXXXXXXXXXXXXXXXXXXXXXXXXXXXXXXXXXXXXXXXXXXXXXXXXXXX-----XXXXXXXXXXXXXXXXXXX--XXXXXXXXXXXXXXX------------XXXX----XXXXXXXXXXXXXXXX--X--
SXXXXXXXXXXXXXXXXXXXXXXXXXXXXXXXXXXXXXXXXXXXXXXXXXXXXXXXXXXXXXXXXXXXXXXXXXXXXXXXXXXXXXXXXXXX--XXXXXXXXXXXXXXXXXXXXXXXXXXXXXXXXXXXXXXXXXXXXXXXXXXXXXX--
