S----SSSSSSSSSSSSSSSSSSSSSSSSSSSSSSSSSSSSSSSSSSSSSSSSSSSSSSSSSSSSSSSSSSSSSSSSSSSSSSSSSSSSSSSSSSSSSSSSSSSSSSSSSSSSSSSSSSSSSSSSSSSSSSSSSSSSSSSSSSSSSSSSS
S------------SSSSSSSSSSSSSSSSSSS-----SSSSS-----------SSSSSSSSSSSSSSSSSSSSSSSSSSSSSSSSSS--------SSSSSSSSSSSSSSSSSSSSSSSSSSS------SSSSSSSSSSSSS-------SS
S-----------------SSSSSSSSSSSSSS-----SSSSS-----------SSSSSSSSSSSSSSSSSSSSSSSSSSSSSSSSSS--------SSSSSSSSSSSSS--------------------SSSSSSSSSSSSS---------
S------------------------SSSSSSS---------------------SSSSSSSSSSSSSS-----SSSSSSSSSSSSSSS--------SSSSSSSS-------------------------SSSSSSSSSSSSS---------
S-----------------------------------------------------------------------------------------------------------------------------------------------------
S-----------------------------------------------------------------------------------------------------------------------------------------------------
S-----------------------------------------------------------------------------------------------------------------------------------------------------
S-----------------------------------------------------------------------------------------------------------------------------------------------------
S--------------------------------------------------------------------------------------------------------------------------------oSooooo----SoSSo-----
S----------------------oSo----------------------------------------------------------------------------------------------------------------------------
S-----------------oo-----------SoooS-----------------------------------------------------------------------oo--------------ooo---ooooo------oooo------
S-----------------------------------------------------oooSo-------------oooo------------------------------------------------k---------------r---------
S-------------XXXXXXXX----------oo--------Y------------------XXXXX-----------------oo-XXXX--------------XXXXXX-----oo----XXXXXXXXXXXXXXXXXXXXXXXXX----
S-------------XXXXXXXXXXXXXXX-Y---k---XXXXXXX-----------oooo-XXXXX-----XXXXXXXXX----r-XXXX-----XXXXX----XXXXXX---------K-XXXXXXXXXXXXXXXXXXXXXXXXXXXXX
S-------------XXXXXXXXXXXXXXXXXXXXXXXXXXXXXXXXXXXXXXX--r-----XXXXX-----XXXXXXXXXXXXXXXXXXX-----XXXXXXXXXXXXXXXXXXXXXXXXXXXXXXXXXXXXXXXXXXXXXXXXXXXXXXX
SXXXXXXXXXXXXXXXXXXXXXXXXXXXXXXXXXXXXXXXXXXXXXXXXXXXXXXXXXXXXXXXXXXXXXXXXXXXXXXXXXXXXXXXXXXXXXXXXXXXXXXXXXXXXXXXXXXXXXXXXXXXXXXXXXXXXXXXXXXXXXXXXXXXXX
