S----SSSSSSSSSSSSSSSSSSSSSSSSSSSSSSSSSSSSSSSSSSSSSSSSSSSSSSSSSSSSSSSSSSSSSSSSSSSSSSSSSSSSSSSSSSSSSSSSSSSSSSSSSSSSSSSSSSSSSSSSSSSSSSSSSSSSSSSSSSSSSSSSS
S----SSSSSSS------SSSSSS------SSSSSSS------SSSSSSS-------------------SSSSSSSSSSSSS--------SSSSSSS-----SSSSSSS------SSSSSSSSSSSSSS------------SSSSSSS--
S----SSSSSSS------SSSSSS------SSSSSSS------SSSSSSS-------------------SSSSSSSSSSSSS--------SSSSSSS-----SSSSSSS-----------------------------------------
S-----------------SSSSSS------SSSSSSS------SSSSSSS---------------------------SSSSS--------------------------------------------------------------------
S-----------------------------------------------------------------------------------------------------------------------------------------------------
S-----------------------------------------------------------------------------------------------------------------------------------------------------
S-----------------------------------------------------------------------------------------------------------------------------------------------------
S-----------------------------------------------------------------------------------------------------------------------------------------------------
S-----------------------------------------------------------------------------------------------------------------------------------------------------
S-------------------------oSo--------------SSo------Sooooo--------------------------------------------------------------------------------------------
S------------oSoooo-----------------------------------------------oooSS----------------------------oooSS----------------------------------------------
S-----------------------oooooo----------------------oooooo----------------------------------ooo-------------------ooo--------ooSo--ooo----------------
S---------------oooooo----y------XXXXX----k--r-XX--------g-XXXXXX-ooooooo-XXXXXXX---XXXXXX--------ooooooo---------------------------g-------oooo------
S----------------------XXXXXXXXXXXXXXX--XXXXXXXXXXXXXXXXXXXXXXXXX--gr-----XXXXXXXXXXXXXXXXXXXXXX----------XXXXX-ooooo--------oo---XXXXXXXX---g---XXXXX
SXXXXXXXXXXXXXXXXXXXXXXXXXXXXXXXXXXXXX--XXXXXXXXXXXXXXXXXXXXXXXXXXXXXXXXXXXXXXXXXXXXXXXXXXXXXXXXXXXXXXXXXXXXXXX-------------------XXXXXXXXXXXXXXXXXXXX
SXXXXXXXXXXXXXXXXXXXXXXXXXXXXXXXXXXXXXXXXXXXXXXXXXXXXXXXXXXXXXXXXXXXXXXXXXXXXXXXXXXXXXXXXXXXXXXXXXXXXXXXXXXXXXXXXXXXXXXXXXXXXXXXXXXXXXXXXXXXXXXXXXXXXX
