S----SSSSSSSSSSSSSSSSSSSSSSSSSSSSSSSSSSSSSSSSSSSSSSSSSSSSSSSSSSSSSSSSSSSSSSSSSSSSSSSSSSSSSSSSSSSSSSSSSSSSSSSSSSSSSSSSSSSSSSSSSSSSSSSSSSSSSSSSSSSSSSSSS
S----SSSSSSSSSSSSSSSSSSSSSSSSSSSSSSSSSSS----------------SSSSSSSSSSSSSSSSSSSSSSSSSSSSSSSSS------SSSSSSSSSSSSSSSSSSS--------------SSSSSSSSSSSSSSSSSSSSSS
S----SSSSS-----------------------SSSSSSS----------------SSSSSSS-------SSSSSSSSSSSSSSSSSSS------SSSSSSSSSSSSSS-------------------SSSSSSSSSSSSSSSSSSS---
S----SSSSS----------------------------------------------SSSSSSS--------------------SSSSSS------SSSSSSSSSSSSSS-------------------SSSSSSSSSSS-----------
S-----------------------------------------------------------------------------------------------------------------------------------------------------
S-----------------------------------------------------------------------------------------------------------------------------------------------------
S-----------------------------------------------------------------------------------------------------------------------------------------------------
S-----------------------------------------------------------------------------------------------------------------------------------------------------
S-------------oooo----------------------ooSS-------------ooo------------------------------------------------------------------------------------------
S------------------------oooo---------------------------------------------------------------------oooooo----------------------------------------------
S-----------------------------------------oo------------ooooooo------oo-------------------------------------------------------Soo---------------------
S-----------------------ooo----------------------------------------------------------------------ooooo----------------oSo-----------------------------
S------------XXXXXXXX------y-----ooooo-XXXXXXXX--------XXXXXXXXXXXXXXXXXX---------------------------------------XXXX-------ooooooo---oo----oo----XXXXX
SXXXXXXXXXXXXXXXXXXXXXXXXXXXXXX-----g--XXXXXXXX--------XXXXXXXXXXXXXXXXXX------oooo--------oooo-XXXXXXXXX-------XXXX------------k-----------r----XXXXX
SXXXXXXXXXXXXXXXXXXXXXXXXXXXXXXXXXXXXXXXXXXXXXXXXXXXXXXXXXXXXXXXXXXXXXXXXXXXXX--------XX----R---XXXXXXXXX-------XXXX-k----XXXXXXXXXXXXXXXXXXXXXXXXXXXX
SXXXXXXXXXXXXXXXXXXXXXXXXXXXXXXXXXXXXXXXXXXXXXXXXXXXXXXXXXXXXXXXXXXXXXXXXXXXXXXXXXXXXXXXXXXXXXXXXXXXXXXXXXXXXXXXXXXXXXXXXXXXXXXXXXXXXXXXXXXXXXXXXXXXXX
