S----SSSSSSSSSSSSSSSSSSSSSSSSSSSSSSSSSSSSSSSSSSSSSSSSSSSSSSSSSSSSSSSSSSSSSSSSSSSSSSSSSSSSSSSSSSSSSSSSSSSSSSSSSSSSSSSSSSSSSSSSSSSSSSSSSSSSSSSSSSSSSSSSS
S----SSSSSSSSSSSS-------SSSSSSSS--------SSSSSSSSSSSSSSSSSSSSS-----SSSSSSSSSSSSSSSSSS--------SSSSS------------------------SSSSSSSSSSSSSSSSSSSS-----SSSS
S----------SSSSSS-------SSSSSSSS---------------SSSSSSSS-----------SSSSSSS-------------------SSSSS------------------------SSSSSSS--------SSSSS-----SSSS
S----------SSSSSS------------------------------SSSSSSSS-----------SSSSSSS------------------------------------------------SSSSSSS------------------SSSS
S-----------------------------------------------------------------------------------------------------------------------------------------------------
S-----------------------------------------------------------------------------------------------------------------------------------------------------
S-----------------------------------------------------------------------------------------------------------------------------------------------------
S-----------------------------------------------------------------------------------------------------------------------------------------------------
S-----------------------------------------------------------------------------------------------------------------------------------------------Sooo--
S-------------------------------------------oooooo-------------------------------oooooSooo------------------------------------------------------------
S------------------------------------ooo--------------ooooo-------------------------------------------------------------------------------------oo----
S-----------------------------------------oooooo-----y--r-r-------------oSSoSo------ooo-----------r--------------Soooo---------------g--------r-------
SXXXXXXXXX---------------------------oo--------K----XXXXXXXX---ooo-XXXX----------gy--------------XXXXXX-----XX-------------oooo-XXXXXXX--ooo-XXXXXXXX-
SXXXXXXXXXXXXX-----XX-----------XX-------XXXXXXXXXXXXXXXXXXX-------XXXX---ooooo-XXXXXXXXXXX----XXXXXXXX-----XX---ooooo------r---XXXXXXX--y---XXXXXXXX-
SXXXXXXXXXXXXXXXXXXXX--------XXXXXXXXXXXXXXXXXXXXXXXXXXXXXXXXXXXXXXXXXX---------XXXXXXXXXXXXXXXXXXXXXXX-----XX----------XXXXXXXXXXXXXXXXXXXXXXXXXXXXXX
SXXXXXXXXXXXXXXXXXXXXXXXXXXXXXXXXXXXXXXXXXXXXXXXXXXXXXXXXXXXXXXXXXXXXXXXXXXXXXXXXXXXXXXXXXXXXXXXXXXXXXXXXXXXXXXXXXXXXXXXXXXXXXXXXXXXXXXXXXXXXXXXXXXXXX
