S----SSSSSSSSSSSSSSSSSSSSSSSSSSSSSSSSSSSSSSSSSSSSSSSSSSSSSSSSSSSSSSSSSSSSSSSSSSSSSSSSSSSSSSSSSSSSSSSSSSSSSSSSSSSSSSSSSSSSSSSSSSSSSSSSSSSSSSSSSSSSSSSSS
S----------SSSSSSSSSSSSSSSSSSSSSSSSSSSSSSSSSSSSSSSSSSSSSSSSSSSSSSSSS-------SSSSSSSSSSSS-----SSSSSSSSSSSSSSSSSSS-------------SSSSSSSSSSSSSSSSSSSSSSSSSS
S----------SSSSSSS--------SSSSSSSS-------------SSSSSSSSSSSSSSSSSSSSS-------SSSSSSSSSSSS-----SSSSSS-----SSSSSSSS------------------SSSSSSSSSSSSSSSSSSSSS
S-------------------------SSSSSSSS--------------------SSSSSSS--------------------SSSSSS-----SSSSSS-----SSSSSSSS------------------SSSSSSSS-------SSSSSS
S-----------------------------------------------------------------------------------------------------------------------------------------------------
S-----------------------------------------------------------------------------------------------------------------------------------------------------
S-----------------------------------------------------------------------------------------------------------------------------------------------------
S-----------------------------------------------------------------------------------------------------------------------------------------------------
S------------------------------------ooooo-------------------------------ooo--------------------------------oSooSoo-----------------------------------
S----------------------------------------------ooSSo---------------------------------------------SSo--------------------ooS---------------------------
S-------------------------------------ooooo-----------------ooSooo--------ooo----------------------------------oooooo-------------oSo-----------------
S-------------oSSSoo----------------------------ooooooo-------------------r-y--------------------oooo-------------y------ooo--------------ooo---------
S-----------------------------------XXXXXXXXXX-------------ooooooo------XXXXXXX--ooo-XX--------------------XXXXXXXXXXX------------ooo-XXX--------g-k--
SXXXXXXXXXXXX-oooooooo------oooooo--XXXXXXXXXXXXXXXXXXXX-------gr-------XXXXXXX------XX--ooo-XXXXXXXXX-----XXXXXXXXXXXXXXXXXXX--k-----XXX------XXXXXXX
SXXXXXXXXXXXX-----------------------XXXXXXXXXXXXXXXXXXXXXXXXXXXXXXX-----XXXXXXXXXXXXXXX------XXXXXXXXXXXXXXXXXXXXXXXXXXXXXXXXXXXXXXXXXXXX------XXXXXXX
SXXXXXXXXXXXXXXXXXXXXXXXXXXXXXXXXXXXXXXXXXXXXXXXXXXXXXXXXXXXXXXXXXXXXXXXXXXXXXXXXXXXXXXXXXXXXXXXXXXXXXXXXXXXXXXXXXXXXXXXXXXXXXXXXXXXXXXXXXXXXXXXXXXXXX
