S----SSSSSSSSSSSSSSSSSSSSSSSSSSSSSSSSSSSSSSSSSSSSSSSSSSSSSSSSSSSSSSSSSSSSSSSSSSSSSSSSSSSSSSSSSSSSSSSSSSSSSSSSSSSSSSSSSSSSSSSSSSSSSSSSSSSSSSSSSSSSSSSSS
S------------SSSSSSSSSS----------------SSSSSSSSSS-------SSSSSSSSSSSSSSSSSSSSSSSSSSSSSSSSSSSSSSSSSSSSSSSSS-----SSSSSSSSSSSSSSSSSSSSSSSSSSSSSSSSS-----SS
S------------SSSSS--------------------------SSSSS-------SSSSSSSSSSSSSSSSSSSSSSSSSSSSSS-------------------------------SSSSSSS-------------SSSSSS-----SS
S------------SSSSS----------------------------------------------SSSSSSSSSSSSSSSSSSSSSS-------------------------------SSSSSSS--------------------------
S-----------------------------------------------------------------------------------------------------------------------------------------------------
S-----------------------------------------------------------------------------------------------------------------------------------------------------
S-----------------------------------------------------------------------------------------------------------------------------------------------------
S-----------------------------------------------------------------------------------------------------------------------------------------------------
S------------------------------------------------------------------------------SoSoo-----oSoSo---------oooSSo-------ooo-----------------------oooo----
S-------------------------------------------------------------------------------------------------------------------------------oSo-------------------
S---------------------------------ooSoS--------------------------ooSSS--------oooooo------ooooooo------oooooo--------------oSo----------------ooo-----
S------------------------------------------------------------------------------------------k-------------------------y--------------------------------
SXXXXXXXXXX---------y--y----oo----ooo---------------ooo------------oo--------XXXXXXXXXXXXXXXXXXXXX----XXXXXXXX---XXXXXXX--ooo-------------XXXXXXXXXX--
SXXXXXXXXXXXXXXXX--XXXXXXX-------------------ooooo-------------------k--XXXXXXXXXXXXXXXXXXXXXXXXXX----XXXXXXXX---XXXXXXX---gy--XXXXXXXXXXXXXXXXXXXXX--
SXXXXXXXXXXXXXXXXXXXXXXXXXXXXXXXXXXXXXXXX-------y--XXXXXX-rG---XXXXXXXXXXXXXXXXXXXXXXXXXXXXXXXXXXXXXXXXXXXXXXX---XXXXXXXXXXXXXXXXXXXXXXXXXXXXXXXXXXX--
SXXXXXXXXXXXXXXXXXXXXXXXXXXXXXXXXXXXXXXXXXXXXXXXXXXXXXXXXXXXXXXXXXXXXXXXXXXXXXXXXXXXXXXXXXXXXXXXXXXXXXXXXXXXXXXXXXXXXXXXXXXXXXXXXXXXXXXXXXXXXXXXXXXXXX
