S----SSSSSSSSSSSSSSSSSSSSSSSSSSSSSSSSSSSSSSSSSSSSSSSSSSSSSSSSSSSSSSSSSSSSSSSSSSSSSSSSSSSSSSSSSSSSSSSSSSSSSSSSSSSSSSSSSSSSSSSSSSSSSSSSSSSSSSSSSSSSSSSSS
S----SSSSSSSSSSSSSSSSSSSSSSSSSSSSSS------SSSSSSSSSSSSSSSSSSSSSSSSSSSSSSSS--------SSSSSSSSSSSSSSSSSSSSSSSSSSS------SSSSSSSSSSSSSSSSSSSSSSSSSSSSSSSSSSSS
S----SSSSSSSSSSSSSSSS--------------------SSSSSSSSSSSSSSSSSSSSSSSSSSSSSSSS--------SSSSS-------SSSSSSSS-------------SSSSSSSSSSSSS--------SSSSSSSSSSSSSSS
S----SSSSSSSSSSSSSSSS--------------------SSSSSS--------------------SSSSSS--------------------SSSSSSSS-----------------------------------------------SS
S-----------------------------------------------------------------------------------------------------------------------------------------------------
S-----------------------------------------------------------------------------------------------------------------------------------------------------
S-----------------------------------------------------------------------------------------------------------------------------------------------------
S-----------------------------------------------------------------------------------------------------------------------------------------------------
S-------------------------SoSo------------------------------------------------------------------------------------------------------------------------
S-------------------------------------------------------------------------oooooooo-----------------------ooooo----SoSo--------------------------------
S-------------------------ooooo--------------------------------------------------------------------------------------------------ooSooo---------------
S--------------oo------------------------------------------oSSS-----------ooooooo------------------------ooo-------oo---------------------------------
SXXXXXXXXXX----k--------XXXXXXXXXX--------oo----XXXXX-------------------------y----XXXX--oo-----------g-------------R-------XX----ooo----------oooo---
SXXXXXXXXXX---XXXXXX----XXXXXXXXXXXXX-----------XXXXX-------oooo---XXXX--XXXXXXXXXXXXXX-kG--------XXXXXXXXXXXXXXXXXXXXX-----XX-r----Kk---XXXXX---k----
SXXXXXXXXXX---XXXXXX----XXXXXXXXXXXXXXXXXXXXXXXXXXXXX---------g-k--XXXXXXXXXXXXXXXXXXXXXXXXXXXXXXXXXXXXXXXXXXXXXXXXXXXX-----XXXXXXXXXXXXXXXXXXXXXXXXX-
SXXXXXXXXXXXXXXXXXXXXXXXXXXXXXXXXXXXXXXXXXXXXXXXXXXXXXXXXXXXXXXXXXXXXXXXXXXXXXXXXXXXXXXXXXXXXXXXXXXXXXXXXXXXXXXXXXXXXXXXXXXXXXXXXXXXXXXXXXXXXXXXXXXXXX
