------------------------------------------------------------------------------------------------------------------------------------------------------
------------------------------------------------------------------------------------------------------------------------------------------------------
------------------------------------------------------------------------------------------------------------------------------------------------------
-----------------------------------------------------------------------------------------------------------------------------------------oooo---------
------------------------------------------------------------------------------------------------------------------------------------------------------
-----------------------------------------------------------------------------------------------------------------------------------------%%%%%--------
-----------------------------------------------------------------------------------------------------------------------------------------|||||--------
-----------------------------------------------------------------------------------------------------------------------------------------|||||--------
-------------------------------------------------------------------------------------------------------------------------------------%%%%%%|||--------
----------------------------------------ooSo-------------------oooS---------------------------------------------------oooS-----------|||||||||--------
---------------------oooo--------oo---------------------oo----------------------------------oooo--oooo-------------------------------|||||||||--------
---------------oo----------------Y--k--ooooo----ooooo---------oooooo----oooo--ooo---------y---------g---------ooooo------oo----k-----||||||r||--------
-----------------k-----------XXXXXXXXX-----------------XXXXXX----------------------------XXXXXXXXXXXXXX-----------------------XXXXXXXXXXXXXXXXXX------
XXXXXXXXXXXXXXXXXXXX----g-XXXXXXXXXXXXXXXXXXXXXXXXXXXXXXXXXXXXXXXXXXX-ooooo--XXXXXXXXXXXXXXXXXXXXXXXXXX-----ooooo----XXXXXXXXXXXXXXXXXXXXXXXXXXXXXXXX-
XXXXXXXXXXXXXXXXXXXXXXXXXXXXXXXXXXXXXXXXXXXXXXXXXXXXXXXXXXXXXXXXXXXXX--------XXXXXXXXXXXXXXXXXXXXXXXXXX-----r--------XXXXXXXXXXXXXXXXXXXXXXXXXXXXXXXXX
XXXXXXXXXXXXXXXXXXXXXXXXXXXXXXXXXXXXXXXXXXXXXXXXXXXXXXXXXXXXXXXXXXXXXXXXXXXXXXXXXXXXXXXXXXXXXXXXXXXXXXXXXXXXXXXXXXXXXXXXXXXXXXXXXXXXXXXXXXXXXXXXXXXXXX
S----SSSSSSSSSSSSSSSSSSSSSSSSSSSSSSSSSSSSSSSSSSSSSSSSSSSSSSSSSSSSSSSSSSSSSSSSSSSSSSSSSSSSSSSSSSSSSSSSSSSSSSSSSSSSSSSSSSSSSSSSSSSSSSSSSSSSSSSSSSSSSSSSS
S------------SSSSSSSSSSSSS-------SSSSSSSSSSSSSSSSSSSSS-------SSSSSSSSSSSSSSSSSSSSSSSSSSSSSSSSSSSSSSSSSSSSSSSSSSSSSSSSS--------SSSSS------SSSSSS-----SS
S-------------------SSSSSS-------SSSSSSSSSSSSSSSSSSSSS-------SSSSSSS-------SSSSSSSSSSSS--------------SSSSS-----SSSSSSS--------------------------------
S--------------------------------SSSSSSSSSSSSS-----------------------------SSSSS---------------------SSSSS--------------------------------------------
S-----------------------------------------------------------------------------------------------------------------------------------------------------
S-----------------------------------------------------------------------------------------------------------------------------------------------------
S-----------------------------------------------------------------------------------------------------------------------------------------------------
S-----------------------------------------------------------------------------------------------------------------------------------------------------
S-----------------------------------------------------------------------------------------------------------------------------------------------------
S----------------------------------------------------ooo-------------------------------------------------Soo------------------------------------------
S---------------------------------oooo------SSo-------------------------ooo----------oSoo------ooSoo------------ooooo-------oSSo----------------------
S--------------ooSoo---------------------------------ooo-------oooooo------------------------------------ooo---------------------------ooSoo----------
S--------------------------------XXXXXXX---oooooo---y---------------g---oo--------XX---ooo---oooooo--------------ooooo--XXX---------------------------
S------------oooo------r---------XXXXXXX--------y--XXXXXXX---XXXXXXXXX-y----------XX-------------kg---XXXXXXXXX---------XXX------------------XXX------
SXXXXXXXXXX------r---XXXXXX------XXXXXXXXXXXXXXXXXXXXXXXXX---XXXXXXXXXXXXXXXXX----XXXXXXXXXXXXXXXXXXXXXXXXXXXXXXXXXXXXXXXXXXXXXXXXX----------XXX---g--
SXXXXXXXXXXXXXXXXXXXXXXXXXXXXXXXXXXXXXXXXXXXXXXXXXXXXXXXXXXXXXXXXXXXXXXXXXXXXXXXXXXXXXXXXXXXXXXXXXXXXXXXXXXXXXXXXXXXXXXXXXXXXXXXXXXXXXXXXXXXXXXXXXXXXX
