S----SSSSSSSSSSSSSSSSSSSSSSSSSSSSSSSSSSSSSSSSSSSSSSSSSSSSSSSSSSSSSSSSSSSSSSSSSSSSSSSSSSSSSSSSSSSSSSSSSSSSSSSSSSSSSSSSSSSSSSSSSSSSSSSSSSSSSSSSSSSSSSSSS
S----SSSSSSSSSSSSSSSSSSSSSSSSSSSSSSSSSSSSSSSSSSSSSSS--------SSSSSSSSSSSSSSSSSSSSSSSSSSSSSSSSSSSSSSSSSSSS--------------SSSSSSSSSSSSSSS------SSSSSSSSSSS
S----SSSSSSSSSSSSSSSSSSSS---------------------SSSSSS---------------SSSSSSSSSSSSSSSS--------SSSSSSSSSSSSS--------------SSSSSSSS--------------------SSSS
S-----------------SSSSSSS------------------------------------------SSSSSSSS----------------SSSSSSSSSSSSS----------------------------------------------
S-----------------------------------------------------------------------------------------------------------------------------------------------------
S-----------------------------------------------------------------------------------------------------------------------------------------------------
S-----------------------------------------------------------------------------------------------------------------------------------------------------
S-----------------------------------------------------------------------------------------------------------------------------------------------------
S----------------------------------oooSoo-------------------------------------oooo----------------------------------------------------------SoSo------
S-----------------------------------------------------------------------------------------------------------------oooSS-------------------------------
S----------------oooSooo------oo----oooo---------------------------------------oooo-------------------oooo---------------------------------ooooo------
S-----------------------------------rg------------------------------oooo-------y-k-----------------------------------ooooo----------ooooo--g----------
SXXXXXXXXXXXXXXX--ooooo----XXXXXXXXXXXXXXXXX----------ooo-------XX----k----XXXXXXXXXXX-------r------------------------------------------k-XXXXXXXXXXXX
SXXXXXXXXXXXXXXX-----r-----XXXXXXXXXXXXXXXXXXXXX-----------g----XXXXXXXXXXXXXXXXXXXXXX--XXXXXXX------------------XXXXXXXXXX--XXXX--XXXXXXXXXXXXXXXXXXX
SXXXXXXXXXXXXXXXXXXXXXXXXXXXXXXXXXXXXXXXXXXXXXXX--XXXXXXXXXXXXXXXXXXXXXXXXXXXXXXXXXXXX--XXXXXXXXXXXXXXXXXXXXXXXXXXXXXXXXXXXXXXXXXXXXXXXXXXXXXXXXXXXXXX
SXXXXXXXXXXXXXXXXXXXXXXXXXXXXXXXXXXXXXXXXXXXXXXXXXXXXXXXXXXXXXXXXXXXXXXXXXXXXXXXXXXXXXXXXXXXXXXXXXXXXXXXXXXXXXXXXXXXXXXXXXXXXXXXXXXXXXXXXXXXXXXXXXXXXX
