S----SSSSSSSSSSSSSSSSSSSSSSSSSSSSSSSSSSSSSSSSSSSSSSSSSSSSSSSSSSSSSSSSSSSSSSSSSSSSSSSSSSSSSSSSSSSSSSSSSSSSSSSSSSSSSSSSSSSSSSSSSSSSSSSSSSSSSSSSSSSSSSSSS
S----SSSSSSSSSSSSSSSSSSSSSSSSSSSSSSSSSSSSSSSSSSSSSSSS------------SSSSSSSSSSSSSSSSSSSSSSSSSSSSSSSSSSSSSSSSSSSSSSSSSS-----SSSSSSSSSSSSSSSSSSS-------SSSS
S------------SSSSSSSSSSSSSS--------SSSSSSSSSSSSSSSSSS------------SSSSSSSSSSS--------SSSSSSS-------SSSSSSSSSSSSSSSSS-------------SSSSSSSSSSS-------SSSS
S------------SSSSSS----------------SSSSSSSSSSSS------------------SSSSS--------------SSSSSSS-------------------SSSSS-------------SSSSSSSSSSS-----------
S-----------------------------------------------------------------------------------------------------------------------------------------------------
S-----------------------------------------------------------------------------------------------------------------------------------------------------
S-----------------------------------------------------------------------------------------------------------------------------------------------------
S-----------------------------------------------------------------------------------------------------------------------------------------------------
S-------------------------oSSoo----oSoo----------------------------------------------------------oSoS-------------------------------------------------
S---------------------------------------------------------------------oooS----------------------------------------------------------------------------
S--------------------------oooo----------------------------------------------------------Sooooo---------ooooS---ooSooSo-------------------------------
S-------------------------g---------y--------------------------------ooooooo---SooSoo---------------------------------------oooo-----ooSS-------------
S------------XXX--------XXXXXXXXXXXXXXXXX------oo-XXX----------------------r-------------ooo----XXXXXXX----oo---ooooooo-----------------------oooooo-X
SXXXXXXXXXX--XXX---XXXXXXXXXXXXXXXXXXXXXX-----k---XXXXX-------------XXXXXXXXX--oooooo----r------XXXXXXX--------------------oo------ooooooo-----------X
SXXXXXXXXXX--XXXXXXXXXXXXXXXXXXXXXXXXXXXXXXXXXXXXXXXXXX-----k-------XXXXXXXXX---k------XXXXXXXXXXXXXXXXXXXXXXXXXXXXXXXXXX---------------g--XXXXXXXXXXX
SXXXXXXXXXXXXXXXXXXXXXXXXXXXXXXXXXXXXXXXXXXXXXXXXXXXXXXXXXXXXXXXXXXXXXXXXXXXXXXXXXXXXXXXXXXXXXXXXXXXXXXXXXXXXXXXXXXXXXXXXXXXXXXXXXXXXXXXXXXXXXXXXXXXXX
