S----SSSSSSSSSSSSSSSSSSSSSSSSSSSSSSSSSSSSSSSSSSSSSSSSSSSSSSSSSSSSSSSSSSSSSSSSSSSSSSSSSSSSSSSSSSSSSSSSSSSSSSSSSSSSSSSSSSSSSSSSSSSSSSSSSSSSSSSSSSSSSSSSS
S----SSSSSSSSSSSSSS-----SSSSSSSSSSSSSSSSSSSSSSSSSS-------SSSSSSSSSSSSSSSSSSSS------SSSSSSSSSSSSSSSSSSSSSSSSSSSSSSSSSSSSSSSSSSSSSSSSSSSSSSSSSSSSSSSSSSS
S----SSSSSSSSSSSSSS-----SSSSSSSSSSSSSSSSSS---------------SSSSSSSSSSSSSSSSSSSS--------------SSSSSSSS-------SSSSSSS-------------SSSSS------SSSSSSSS-----
S----SSSSSSSSSSSSSS--------------------------------------SSSSSSSS--------------------------SSSSSSSS---------------------------SSSSS------SSSSSSSS-----
S-----------------------------------------------------------------------------------------------------------------------------------------------------
S-----------------------------------------------------------------------------------------------------------------------------------------------------
S-----------------------------------------------------------------------------------------------------------------------------------------------------
S-----------------------------------------------------------------------------------------------------------------------------------------------------
S-----------------------------------------------------------------------------------------------------------------oooo--------------------------------
S-----------------------------------------------SoSSS-----------------------oSSoSoo-------------------------------------------------------------------
S--------------ooo-----------------------------------------------oSSSoSS------------------------oSoooooo-----------ooooo-----------oooo---------------
S------------------------oo------oSo------------oooooo---------------------ooooo--------------------------------R-g-y-----oooSS-----------------------
SXXXXXXXXXXXX---------------XXXX------------------y-----------------ooo--------------------y-----oooo----------XXXXXXXXXX-------------oooo-----------X
SXXXXXXXXXXXX--------XXXXXXXXXXX-------------XXXXXXXXXXX-ooo------g----y--XXXXXXXXXX-----XXXXXX----k-----------XXXXXXXXXX-ooooooo--k-------XXXXXXXX--X
SXXXXXXXXXXXXXXXXXXXXXXXXXXXXXXX-------------XXXXXXXXXXX--------XXXXXXXXXXXXXXXXXXXXXX---XXXXXXXXXXXXXXXXXXXXXXXXXXXXXXXX-r-----r-XXXXXXXXXXXXXXXXX--X
SXXXXXXXXXXXXXXXXXXXXXXXXXXXXXXXXXXXXXXXXXXXXXXXXXXXXXXXXXXXXXXXXXXXXXXXXXXXXXXXXXXXXXXXXXXXXXXXXXXXXXXXXXXXXXXXXXXXXXXXXXXXXXXXXXXXXXXXXXXXXXXXXXXXXX
