S----SSSSSSSSSSSSSSSSSSSSSSSSSSSSSSSSSSSSSSSSSSSSSSSSSSSSSSSSSSSSSSSSSSSSSSSSSSSSSSSSSSSSSSSSSSSSSSSSSSSSSSSSSSSSSSSSSSSSSSSSSSSSSSSSSSSSSSSSSSSSSSSSS
S----------SSSSSSSSSSSSS------SSSSSSSSSSSSSSSSSSSSSSS-----SSSSS---------------SSSSSSSSSSSSSSSSSSSSSSSSSSSSSSSSSSSSSSSSSSSSSSSSS--------SSSSSSSSSSSSSSS
S----------SSSSSS-------------------------SSSSSSSSSSS-----SSSSS---------------SSSSSSSSSSSSSSSSSSSSS-------SSSSSSSSSSSSSSSSSSSSS--------SSSSSSSSSSSS---
S----------SSSSSS-------------------------SSSSSSSSSSS-----SSSSS-----------------------SSSSSSSSSSSSS-------SSSSS--------SSSSSSSS--------SSSSSSSSSSSS---
S-----------------------------------------------------------------------------------------------------------------------------------------------------
S-----------------------------------------------------------------------------------------------------------------------------------------------------
S-----------------------------------------------------------------------------------------------------------------------------------------------------
S-----------------------------------------------------------------------------------------------------------------------------------------------------
S-------------------------------------------oSo----------SoSo-----------------------------------------------------------------------Soooo-------------
S-------------------------------------------------------------------------------ooSoo-----------------------------------------------------------------
S---------------------------------Sooo------oooo--------ooo----------SSoSSo-------------------------------------------------------oooo-------oo-------
S--------------------------------------------g---------kg--Y---------------------ooo---ooooSS----------ooS--------------------g------r----------------
SXXXXXXXXXXXXXXXXX-----------------oooo--XXXXXXXXX---XXXXXXXXXX--------ooooo----y-----------------------------------------XXXXXXXXXXXXXXXXXXXXXXX-----
SXXXXXXXXXXXXXXXXX--------------k--------XXXXXXXXX---XXXXXXXXXX------y-------XXXXXXXXX-ooooo-----------ooooo--------------XXXXXXXXXXXXXXXXXXXXXXX-----
SXXXXXXXXXXXXXXXXXXXXXX--------XXXXXXXXXXXXXXXXXXX---XXXXXXXXXXXXXXXXXXXXXXXXXXXXXXXXX----k-----------y-------XXXXX-------XXXXXXXXXXXXXXXXXXXXXXXXXXXX
SXXXXXXXXXXXXXXXXXXXXXXXXXXXXXXXXXXXXXXXXXXXXXXXXXXXXXXXXXXXXXXXXXXXXXXXXXXXXXXXXXXXXXXXXXXXXXXXXXXXXXXXXXXXXXXXXXXXX---XXXXXXXXXXXXXXXXXXXXXXXXXXXXXX
