S----SSSSSSSSSSSSSSSSSSSSSSSSSSSSSSSSSSSSSSSSSSSSSSSSSSSSSSSSSSSSSSSSSSSSSSSSSSSSSSSSSSSSSSSSSSSSSSSSSSSSSSSSSSSSSSSSSSSSSSSSSSSSSSSSSSSSSSSSSSSSSSSSS
S----SSSSSSSSSSSSSSSSSSSSSSSSSSSSSSSSSSS------SSSSSSS----------------SSSSSS--------SSSSSSSSSSSSSSSSSSSSSSSSSSSSSSSSSSSSSSSSSSSSSSSSSSSSSS-----SSSSSSSS
S----------SSSSSSSS------SSSSSSSSSSSSSSS------SSSSSSS------------------------------SSSSSSSSSSSSSSSSSSSSSSSSSS---------------------------------SSSSS---
S----------SSSSSSSS------SSSSSSSSSSSSSSS--------------------------------------------------------SSSSSSSS----------------------------------------------
S-----------------------------------------------------------------------------------------------------------------------------------------------------
S-----------------------------------------------------------------------------------------------------------------------------------------------------
S-----------------------------------------------------------------------------------------------------------------------------------------------------
S-----------------------------------------------------------------------------------------------------------------------------------------------------
S-------------------------------------------Soooo---------------oooooooSo---------------------------------------------------oooo----------------------
S--------------------------------SoSoooo------------oSooo--------------------------------------------------------oSSSo-----------------------ooSo-----
S-------------------------------------------ooo-------------------ooooo---------------------Soo-------------------------------------------------------
S-------------------oSooS--------oooooo-------g-----ooooo-----------r---k-----------------------------------------ooooo--------------------ooo--------
S---------------------------XXX------Y---XXXXXXXXXX------K-----XXXXXXXXXXXXXXX---------------ooo-------------------------XXXXXXXX---XXXXX---------XXXX
S-------------XXX----ooo----XXXXXXXXXXXXXXXXXXXXXXXXXXXXXXXXXXXXXXXXXXXXXXXXXX---XXXX----------------oo---------XXXXXXXXXXXXXXXXX---XXXXXXXXXXXXXXXXXX
SXXXXXXXXXXXXXXXX-----------XXXXXXXXXXXXXXXXXXXXXXXXXXXXXXXXXXXXXXXXXXXXXXXXXXXXXXXXX----XXXXXXXXXX-------------XXXXXXXXXXXXXXXXXXXXXXXXXXXXXXXXXXXXXX
SXXXXXXXXXXXXXXXXXXXXXXXXXXXXXXXXXXXXXXXXXXXXXXXXXXXXXXXXXXXXXXXXXXXXXXXXXXXXXXXXXXXXXXXXXXXXXXXXXXXXXXXXXXXXXXXXXXXXXXXXXXXXXXXXXXXXXXXXXXXXXXXXXXXXX
