S----SSSSSSSSSSSSSSSSSSSSSSSSSSSSSSSSSSSSSSSSSSSSSSSSSSSSSSSSSSSSSSSSSSSSSSSSSSSSSSSSSSSSSSSSSSSSSSSSSSSSSSSSSSSSSSSSSSSSSSSSSSSSSSSSSSSSSSSSSSSSSSSSS
S----SSSSSSSSSSSSS------------SSSSS-----SSSSSSSSSSSSSSSSSSSSSSSSSSSSSS-----SSSSSSSSSSSSSSSSSSSSSSSSSSSSSSSSSSSSSSSSSSSSSSSSSSSSSSSS-----SSSSS---------
S----SSSSSS-----------------------------SSSSSSSSSS------SSSSSSS------------SSSSSSSSSSSSSSSSSSSSSSS---------------------SSSSSSS------------------------
S----SSSSSS----------------------------------SSSSS------SSSSSSS------------------------------SSSSS----------------------------------------------------
S-----------------------------------------------------------------------------------------------------------------------------------------------------
S-----------------------------------------------------------------------------------------------------------------------------------------------------
S-----------------------------------------------------------------------------------------------------------------------------------------------------
S-----------------------------------------------------------------------------------------------------------------------------------------------------
S---------------------------------------oSSo--oooooooo--------------SSo-------oSooS-------------------------------------------------------------------
S----------------------------------------------------------------------------------------------Soooo--------------------------------------------------
S----------------------------------------------oooooo------------oooooo---------oo------------------------------ooooSo--------------------------------
S-------------ooo-----SSSo--------------------------------------------------------k---------oooooooo----------------------SSooo-----ooooo-------ooSS--
S--------------------------------------XXXXXXXXXXXXXXXX----XXXXXXXXXXXXXX----XXXXXXXXX------------------oo------ooo--------------yy-------------------
S-----------XXXXXX----oo----XXXXX------XXXXXXXXXXXXXXXX----XXXXXXXXXXXXXX----XXXXXXXXX-----XXXXXXXXXX----------r----g---ooooooo-XXXXXXXXXX---------oo-
S-----------XXXXXX----------XXXXXXXXXXXXXXXXXXXXXXXXXXX----XXXXXXXXXXXXXX----XXXXXXXXXXXXXXXXXXXXXXXXXXXXXXXXXXXXXXXXXX---------XXXXXXXXXX------------
SXXXXXXXXXXXXXXXXXXXXXXXXXXXXXXXXXXXXXXXXXXXXXXXXXXXXXXXXXXXXXXXXXXXXXXXXXXXXXXXXXXXXXXXXXXXXXXXXXXXXXXXXXXXXXXXXXXXXXXXXXXXXXXXXXXXXXXXXXXXXXXXXXXXXX
