S----SSSSSSSSSSSSSSSSSSSSSSSSSSSSSSSSSSSSSSSSSSSSSSSSSSSSSSSSSSSSSSSSSSSSSSSSSSSSSSSSSSSSSSSSSSSSSSSSSSSSSSSSSSSSSSSSSSSSSSSSSSSSSSSSSSSSSSSSSSSSSSSSS
S-----------SSSSSSSSSSSSSSSSSSSSSSSSSSSSSSSSSSSSSSSSSSSSSS--------SSSSSSSSSSSSS-------SSSSSSSSSSSSSSSSSSSSSSSSSSSSSSSS-----SSSSSSSSSSSSSSSSSSSSSSSSSSS
S-----------SSSSSSSS-------SSSSSSSSSSSSSSSSSSSSSSS---------------------SSSSSSSS---------------SSSSSSSSSSSSSSSSSSSSSSSS---------------------------SSSSS
S-----------SSSSSSSS-------SSSSSSSSSSSSSSS--------------------------------------------------------------------SSSSSSSS--------------------------------
S-----------------------------------------------------------------------------------------------------------------------------------------------------
S-----------------------------------------------------------------------------------------------------------------------------------------------------
S-----------------------------------------------------------------------------------------------------------------------------------------------------
S-----------------------------------------------------------------------------------------------------------------------------------------------------
S------------------------------------ooooo----------ooo------------------------------------------------------oooo-------------------------------------
S--------------------------------------------------------------------------ooSS-----------------------------------------------------------------------
S----------------oSooSoo----------------ooo-----------ooo------------ooS-----------------------------SoSo------oooo-----------------------------------
S----------------------------------------------------------------------------ooooo------------------------------------------SooSSoo-------------------
S-----------------oooooo----oooo----XXXXXXXXX------XXXXXXX----------ooooo---------------------------ooooo--XXXXXXXXX----------------------------------
S----------------------k--------y-XXXXXXXXXXXXXXXXXXXXXXXX----------------XXXXXXXXX----oooo--------k-------XXXXXXXXXXXXXX---ooooo---------------------
SXXXXXXXXXXX----XXXXXXXXXXXXXXXXXXXXXXXXXXXXXXXXXXXXXXXXXXXXXXXXXXXXXXXXXXXXXXXXXXX-g------------XXXXXXXXXXXXXXXXXXXXXXXX-y------g--XXX--XXXXXXXXXXXXX
SXXXXXXXXXXXXXXXXXXXXXXXXXXXXXXXXXXXXXXXXXXXXXXXXXXXXXXXXXXXXXXXXXXXXXXXXXXXXXXXXXXXXXXXXXXXXXXXXXXXXXXXXXXXXXXXXXXXXXXXXXXXXXXXXXXXXXXXXXXXXXXXXXXXXX
