S----SSSSSSSSSSSSSSSSSSSSSSSSSSSSSSSSSSSSSSSSSSSSSSSSSSSSSSSSSSSSSSSSSSSSSSSSSSSSSSSSSSSSSSSSSSSSSSSSSSSSSSSSSSSSSSSSSSSSSSSSSSSSSSSSSSSSSSSSSSSSSSSSS
S----SSSSSSSSSSSSSSSS------SSSSSSSSSSSSSSSSSSSSSS-------------SSSSSSS--------SSSSSSSSSSSSSSSSSSSSSS-------SSSSSSS------SSSSSSSSSSSSSSSSSSSSSSSSSSSSSSS
S--------------------------SSSSSSSSSSSSSSS-----------------------------------SSSSSSSSSSS-----SSSSSS--------------------SSSSSSSSSSSSSS------SSSSSSSSSSS
S--------------------------SSSSSSSS------------------------------------------SSSSSSSSSSS-----SSSSSS--------------------SSSSSS-------------------------
S-----------------------------------------------------------------------------------------------------------------------------------------------------
S-----------------------------------------------------------------------------------------------------------------------------------------------------
S-----------------------------------------------------------------------------------------------------------------------------------------------------
S-----------------------------------------------------------------------------------------------------------------------------------------------------
S-------------------------------------------------------------------------------------------------------------------------------Sooo------------------
S---------------------------------------oooooo----------------------------oooSSo----------------------------------------------------------------------
S-----------------------------------------------------oSSoooSoo------------------------------------oSooooooo-------------ooSo-----oooo----------------
S---------------------------------------ooooo--------------------ooo-------ooooo--oSSooo--ooo--------------------------------------G-kg---------------
S------------------------------tt-----------------------oooo-----------------------------------------ooooo-------Tt----ooo----XXXXXXXXXX--------------
S--------------XXXXXX----Tt-Tt-tt---XXXXXXXXXXX------------rr---XXXXXXXXXXXXXXXXX--------XXXXXXX----y------------Tt-----------XXXXXXXXXX--------oo----
SXXXXXXXXXXXXXXXXXXXX----Tt-Tt-tt-XXXXXXXXXXXXX------XXXXXXXXXXXXXXXXXXXXXXXXXXXX--------XXXXXXX--XXXXXXXXXXXXXXXXXXXXXXXXXXXXXXXXXXXXXX-g--k-------k-
SXXXXXXXXXXXXXXXXXXXXXXXXXXXXXXXXXXXXXXXXXXXXXXXXXXXXXXXXXXXXXXXXXXXXXXXXXXXXXXXXXXXXXXXXXXXXXXXXXXXXXXXXXXXXXXXXXXXXXXXXXXXXXXXXXXXXXXXXXXXXXXXXXXXXX
