S----SSSSSSSSSSSSSSSSSSSSSSSSSSSSSSSSSSSSSSSSSSSSSSSSSSSSSSSSSSSSSSSSSSSSSSSSSSSSSSSSSSSSSSSSSSSSSSSSSSSSSSSSSSSSSSSSSSSSSSSSSSSSSSSSSSSSSSSSSSSSSSSSS
S----SSSSSSSSSSSSSSSSSSSSSSSSSSSSSSSSSSSSSSSSSSSSSSSSSSS-----------------SSSSSSSS------SSSSSSSSSSSSSS-----SSSSSSSSSSSSSSSSSSSSSSSSSSSSSSSSSSSSSSSSSSSS
S----SSSSSSSSSSSSS-----SSSSSSSSSSSSSSSSSSSSSSSSSSSSSSSSS-------------------------------SSSSSS--------------------------SSSSSSS-------------------SSSSS
S-----------------------------SSSSSSSSSSSSSSSSSSSS-----------------------------------------------------------------------------------------------SSSSS
S-----------------------------------------------------------------------------------------------------------------------------------------------------
S-----------------------------------------------------------------------------------------------------------------------------------------------------
S-----------------------------------------------------------------------------------------------------------------------------------------------------
S-----------------------------------------------------------------------------------------------------------------------------------------------------
S--------------------------ooooo--------------------SSoooSo--------------ooo----------------------------------------------------------oSoo------------
S---------------------------------------------------------------oooo------------ooSSo-----------------------------------------------------------------
S------------------------oooooooo--------------------ooooo------------------------------oo----------------------------------ooooo----oooo-------------
S----------------------------------------------------g-------ooooooo------------ooo----rr---------------------oSo------------------k---------oooooSo--
S----------XXXXXXXXXXXXXXXXXXXXXXX----------XXXXXXXXXXXXXXXX------------XXXXXX-k---g--XXXXXXX----------XXX------------------oo----XXXXXXXXXX----------
SXXXXXXXXXXXXXXXXXXXXXXXXXXXXXXXXX----------XXXXXXXXXXXXXXXXXXXXXXXXX---XXXXXXXXXXXXXXXXXXXXX----------XXX-ooooooo----------------XXXXXXXXXX---ooo----
SXXXXXXXXXXXXXXXXXXXXXXXXXXXXXXXXXXXXXXXXXXXXXXXXXXXXXXXXXXXXXXXXXXXX---XXXXXXXXXXXXXXXXXXXXX----------XXX--------------XXXXXXXXXXXXXXXXXXXX--r-------
SXXXXXXXXXXXXXXXXXXXXXXXXXXXXXXXXXXXXXXXXXXXXXXXXXXXXXXXXXXXXXXXXXXXXXXXXXXXXXXXXXXXXXXXXXXXXXXXX--XXXXXXXXXXXXXXXXXXXXXXXXXXXXXXXXXXXXXXXXXXXXXXXXXXX
