S----SSSSSSSSSSSSSSSSSSSSSSSSSSSSSSSSSSSSSSSSSSSSSSSSSSSSSSSSSSSSSSSSSSSSSSSSSSSSSSSSSSSSSSSSSSSSSSSSSSSSSSSSSSSSSSSSSSSSSSSSSSSSSSSSSSSSSSSSSSSSSSSSS
S----------SSSSSSSSSSSSSSSSSSSSSSSSSSSSSSSSSSSSSSSSSSSSSSSSSSSSS-------SSSSSSSSSSSSSSSSSSSSSSSSSSSSSSSSSSSSSSSS--------SSSSSSSSSSSSSSSSSSSSSSSSSSSSSSS
S----------SSSSSSSSSSSSSSSSSSS--------SSSSSSSSSSSSSSSSSSS-------------------------SSSSSSSSSSSSSSSSSSSSSSSSSSSSS--------SSSSSSSS-----SSSSSS--------SSSS
S---------------SSSSSSSSSSSSSS----------------SSSSSS---------------------------------------------SSSSSSSSSSSSSS--------SSSSSSSS-----SSSSSS--------SSSS
S-----------------------------------------------------------------------------------------------------------------------------------------------------
S-----------------------------------------------------------------------------------------------------------------------------------------------------
S-----------------------------------------------------------------------------------------------------------------------------------------------------
S-----------------------------------------------------------------------------------------------------------------------------------------------------
S---------------oSo----------------------------------------------------------------------------------------------------------oSSSoo-------------------
S-------------------------------------------------------------------------ooSoo---------------oooo----------------------------------------------------
S--------------oo--------------ooSSS-------------------ooooo--------------------------------------------SoSo---oSoSooo--------oooooooo-----oooo-------
S----------------y-----------------------SSSSS--------------------------ooooooo--------------oooooo---------------------------g-----------------------
SXXXXXXXXXX---XXXXXXX-----XXX---ooo---------------------oooo----ooo------k----r-----XXXXXXX--------Y-----------ooooo--------XXXXXXXXXXX-ooooooo---XX--
SXXXXXXXXXX---XXXXXXXXXXXXXXX--------r--ooooo------------r---g----K-y-XXXXXXXXXXX---XXXXXXXXXXXXXXXXX------g---------y-XXXXXXXXXXXXXXXX-----------XXXX
SXXXXXXXXXXXXXXXXXXXXXXXXXXXXXXXXXXXXXX---------XXXXXXXXXXXXXXXXXXXXXXXXXXXXXXXXX---XXXXXXXXXXXXXXXXXXXXXXXXXXXXXXXXXXXXXXXXXXXXXXXXXXXXXXXXXXXXXXXXXX
SXXXXXXXXXXXXXXXXXXXXXXXXXXXXXXXXXXXXXXXXXXXXXXXXXXXXXXXXXXXXXXXXXXXXXXXXXXXXXXXXXXXXXXXXXXXXXXXXXXXXXXXXXXXXXXXXXXXXXXXXXXXXXXXXXXXXXXXXXXXXXXXXXXXXX
