S----SSSSSSSSSSSSSSSSSSSSSSSSSSSSSSSSSSSSSSSSSSSSSSSSSSSSSSSSSSSSSSSSSSSSSSSSSSSSSSSSSSSSSSSSSSSSSSSSSSSSSSSSSSSSSSSSSSSSSSSSSSSSSSSSSSSSSSSSSSSSSSSSS
S----SSSSSSSSSSSSSSSSSSSSSSSSSSSSSSSSSSSSSSSSSSSSSSSSSSSSSSSSSSSSSSSS--------SSSSSSSSSSSSSSSSS------SSSSS--------SSSSSS--------------SSSSSSSSSSSSSSSSS
S---------SSSSSSSSSSSSSSSSSSSSSSSSSSSSSSSSSSSSSSSS--------SSSSSSSSSSS--------SSSSSSSSSSSSSSSSS------SSSSS------------------------------------------SSS
S---------SSSSSSSS-------SSSSSSS--------SSSSSSSSSS--------SSSSSSSSSSS------------------SSSSSSS--------------------------------------------------------
S-----------------------------------------------------------------------------------------------------------------------------------------------------
S-----------------------------------------------------------------------------------------------------------------------------------------------------
S-----------------------------------------------------------------------------------------------------------------------------------------------------
S-----------------------------------------------------------------------------------------------------------------------------------------------------
S--------------oSoo-------------------------------------------------------------------------------------------------oooSS-----------------------------
S----------------------------------------------------------------------------ooooo--------------------------------------------------------------------
S-------------oooooooo-------------------------------------------------------------------------------------oSSoSSo---oooo------------oSSS------ooooo--
S--------------y----------------------------------Soo---SoS------------------oooo------------------------------------y----r--------------------y-r-g--
S------------XXXXXXXXXX-----------------------------------------------kg---------r-------------XXXXXXX-------ooooo-XXXXXXXXXX------oooooooo-XXXXXXXXXX
S------------XXXXXXXXXXXXXXXXXXXXXXX----oo-----oooooo---oo----XXXXXXXXXXX--XXXXXXXXX------oo---XXXXXXX---------Rg--XXXXXXXXXX--------g------XXXXXXXXXX
S------------XXXXXXXXXXXXXXXXXXXXXXXXX------------g-y---------XXXXXXXXXXXXXXXXXXXXXXXX---------XXXXXXXXXXXXXXXXXXXXXXXXXXXXXX-----XXXXXXXXXXXXXXXXXXXX
SXXXXXXXXXXXXXXXXXXXXXXXXXXXXXXXXXXXXXXXXXXXXXXXXXXXXXXXXXXXXXXXXXXXXXXXXXXXXXXXXXXXXXXXXXXXXXXXXXXXXXXXXXXXXXXXXXXXXXXXXXXXXXXXXXXXXXXXXXXXXXXXXXXXXX
