S----SSSSSSSSSSSSSSSSSSSSSSSSSSSSSSSSSSSSSSSSSSSSSSSSSSSSSSSSSSSSSSSSSSSSSSSSSSSSSSSSSSSSSSSSSSSSSSSSSSSSSSSSSSSSSSSSSSSSSSSSSSSSSSSSSSSSSSSSSSSSSSSSS
S----SSSSSSSSSSSSSSSSSSSSSSSSSSSSSSSSSSSSSSSSSSSSSSSSSSSSSSSSSSSSSSSSS-------SSSSSS--------------------SSSSSSSSSSSSSSSSSSSSSSSSSSS------SSSSSSSSSSSSSS
S---------SSSSSSSSSSSSSSSSSSSSSSSSSSSSSSSSSSSSSSSSSSSSSSSSSSSSSS---------------------------------------SSSSSS--------SSSSSSSS-------------------------
S---------SSSSSSSSSSSSSSSSSSSS--------SSSSSSSS------SSSSSSSSSSSS---------------------------------------SSSSSS--------SSSSSSSS-------------------------
S-----------------------------------------------------------------------------------------------------------------------------------------------------
S-----------------------------------------------------------------------------------------------------------------------------------------------------
S-----------------------------------------------------------------------------------------------------------------------------------------------------
S-----------------------------------------------------------------------------------------------------------------------------------------------------
S-----------------------------------------------ooo---------------------------------------------------------------------------------------------------
S--------------------------------------------------------------------oSoSSoooo------------------------------------------------------------------------
S-----------------------------------------------ooo------------oooo-------------------------SSo-------------------------------------------------------
S-----------ooSoooo-----------------------------------------------------oooo--------------------------------SSoo---ooo-------ooooo--------------------
S---------------------------XXXXXXXXXXXXXX---XXXXXXXX-------------------y------XXXXXXX------oooo--------------------------------------oo-----k--------
S------------oooooo---ooo---XXXXXXXXXXXXXXXXXXXXXXXXX----r----------XXXXXXXXXXXXXXXXXXXX---yg--------------------XXXXXXX--XXXXXXXXX------XXXXXXXXX----
S------------k--g-k---------XXXXXXXXXXXXXXXXXXXXXXXXXXXXXXX---XXXXXXXXXXXXXXXXXXXXXXXXXXXXXXXXXXXXXXXXXX---------XXXXXXX--XXXXXXXXXXXXXXXXXXXXXXXXXXXX
SXXXXXXXXXXXXXXXXXXXXXXXXXXXXXXXXXXXXXXXXXXXXXXXXXXXXXXXXXXXXXXXXXXXXXXXXXXXXXXXXXXXXXXXXXXXXXXXXXXXXXXXXXXXXXXXXXXXXXXXXXXXXXXXXXXXXXXXXXXXXXXXXXXXXX
