S----SSSSSSSSSSSSSSSSSSSSSSSSSSSSSSSSSSSSSSSSSSSSSSSSSSSSSSSSSSSSSSSSSSSSSSSSSSSSSSSSSSSSSSSSSSSSSSSSSSSSSSSSSSSSSSSSSSSSSSSSSSSSSSSSSSSSSSSSSSSSSSSSS
S----SSSSSSS------SSSSSS-------SSSSSSSSSSSSSSSSSSSSS-------SSSSSSSSSSSSSSSSSSSSSSSS--------SSSSS------SSSSSSSSSSSSSSSSSSS-------SSSSSSSSSSSSSSSSSS----
S----SSSSSSS-------------------SSSSSSSS--------SSSSS-------SSSSSS-----SSSSSSS-------------------------SSSSSSSSSSSSSSSSSSS-------SSSSSSSSSSSSSSSSSS----
S------------------------------SSSSSSSS--------------------SSSSSS-----SSSSSSS-------------------------------------SSSSSSS-------------------SSSSSS----
S-----------------------------------------------------------------------------------------------------------------------------------------------------
S-----------------------------------------------------------------------------------------------------------------------------------------------------
S-----------------------------------------------------------------------------------------------------------------------------------------------------
S-----------------------------------------------------------------------------------------------------------------------------------------------------
S--------------------------------------------------------------------------------------------------------------SSoooo----Sooo----oSo-----oooSo--------
S----------oooooo-------------------ooooS-------------------------------------------------------------------------------------------------------------
S--------------------oooo--------------------ooo----ooSooo------------ooS---------------------------------------oooo-------oo----ooo-------oooooo-----
S-----------ooooo-------------------ooooooo--------------------oooo------------ooo--ooooo---SoS-----------------g-----------r----r-K------------------
SXXXXXXXXX-y--g-----XXXXXX------------------XXXXXX---oooo------------ooo-----------------------------XXXXX--XXXXXXXXXXXXXXXXXXXXXXXXXXXXXXXXXXXXXX----
SXXXXXXXXXXXXXXXXXXXXXXXXX----oo---XXXXXXXXXXXXXXX-k-----------ooo-----k-----oo-------oo------oo-----XXXXX--XXXXXXXXXXXXXXXXXXXXXXXXXXXXXXXXXXXXXXXXXX
SXXXXXXXXXXXXXXXXXXXXXXXXX----k----XXXXXXXXXXXXXXXXXXXXXXXXXX-------XXXXXXX-G-------y----------kr-XXXXXXXX--XXXXXXXXXXXXXXXXXXXXXXXXXXXXXXXXXXXXXXXXXX
SXXXXXXXXXXXXXXXXXXXXXXXXXXXXXXXXXXXXXXXXXXXXXXXXXXXXXXXXXXXXXXXXXXXXXXXXXXXXXXXXXXXXXXXXXXXXXXXXXXXXXXXXXXXXXXXXXXXXXXXXXXXXXXXXXXXXXXXXXXXXXXXXXXXXX
