S----SSSSSSSSSSSSSSSSSSSSSSSSSSSSSSSSSSSSSSSSSSSSSSSSSSSSSSSSSSSSSSSSSSSSSSSSSSSSSSSSSSSSSSSSSSSSSSSSSSSSSSSSSSSSSSSSSSSSSSSSSSSSSSSSSSSSSSSSSSSSSSSSS
S----SSSSSSSSSSSSSSSSSSSSSSSSSSSSSSSSSSSSSSSSSSSSS-------SSSSSSSSSSSS-------SSSSSSSSSSSSSSSSSSS------SSSSSSSSSSSSSS----------SSSSSSSSSSSSSSS-------SSS
S----SSSSSSSS--------SSSSSSSSSSSSSSSS-------SSSSSS-------SSSSSSSSSSSS-------SSSSSSSSSSSSSSSSSSS------SSSSSSS------------------------SSSSSSSS-------SSS
S--------------------SSSSSSSSSSSSSSSS---------------------------SSSSS-------SSSSSSS------------------SSSSSSS---------------------------------------SSS
S-----------------------------------------------------------------------------------------------------------------------------------------------------
S-----------------------------------------------------------------------------------------------------------------------------------------------------
S-----------------------------------------------------------------------------------------------------------------------------------------------------
S-----------------------------------------------------------------------------------------------------------------------------------------------------
S----------------------------------------------------------------------------------------------ooS-----------------ooSoo------------------------------
S----------------ooo------------------Soo--------------------oooo--------------------------------------------------------------------------------*----
S--------------------------------------------------tt-Tt----------------------------------------oo---------------ooooooo-------------------------*----
S-------------ooo--------r------------oooo---------tt-Tt--ooooooooo-------------------------------gr-------------R--------------------oooo--*----*----
S--------------------XXXXXX------------y-----------tt-Tt--------------------ooo----oooo------XXXXXXXXX----ooooo-XXXXXXXXX-----------k------XXXXXXXXXXX
S------------XXXXXXXXXXXXXX--ooo---XXXXXXXXX----XXXXXXXXXXXXXXXXXXXX-----XX-----r------------XXXXXXXXX----R-----XXXXXXXXX----r-----XXXXXXXXXXXXXXXXXXX
S------------XXXXXXXXXXXXXX----y---XXXXXXXXX----XXXXXXXXXXXXXXXXXXXX-----XXXXXXXXXXXXXXXXXXXXXXXXXXXXXXXXXXXXXXXXXXXXXXXXXXXXXX----XXXXXXXXXXXXXXXXXXX
SXXXXXXXXXXXXXXXXXXXXXXXXXXXXXXXXXXXXXXXXXXXXXXXXXXXXXXXXXXXXXXXXXXXXXXXXXXXXXXXXXXXXXXXXXXXXXXXXXXXXXXXXXXXXXXXXXXXXXXXXXXXXXXXXXXXXXXXXXXXXXXXXXXXXX
