S----SSSSSSSSSSSSSSSSSSSSSSSSSSSSSSSSSSSSSSSSSSSSSSSSSSSSSSSSSSSSSSSSSSSSSSSSSSSSSSSSSSSSSSSSSSSSSSSSSSSSSSSSSSSSSSSSSSSSSSSSSSSSSSSSSSSSSSSSSSSSSSSSS
S----SSSSSSSSSSS-----------SSSSSS---------------SSSSSSSS-------SSSSSSSSSSSSSSSSSSSSSSSSSSSSSSSSSSS-----SSSSS-----------------------SSSSSSSS-----------
S----SSSSS--------------------------------------SSSSSSSS------------SSSSSS------SSSSSSSSSSSSSSSSSS-----SSSSS-----------------------SSSSSSSS-----------
S-------------------------------------------------------------------------------SSSSSSSSSSSSS---------------------------------------------------------
S-----------------------------------------------------------------------------------------------------------------------------------------------------
S-----------------------------------------------------------------------------------------------------------------------------------------------------
S-----------------------------------------------------------------------------------------------------------------------------------------------------
S-----------------------------------------------------------------------------------------------------------------------------------------------------
S-----------------------------------------------------------------oooooSo--------------------------------------oSS------------------------------------
S---------------------------------------ooSSSo------------------------------SSo-------------------------------------------------------ooSSSSo---------
S-------------------ooooSSSo----Soo-------------------------------oooo-----------------------------------------oooo-----------------------------------
S-----------------------------------------ooo-----------oSooo-----y----k---------------------------------------Y---------------------oooooooo---------
S------------------oooooooo-----ooooo---------rr---------------XXXXXXXXXXX----R---ooooo---------XXXX-------XXXXXXXXXXXX-------------r-----------------
SXXXXXXXXXXXXX-------y-----k----------XXXXXXXXXXXXXXXX---ooo---XXXXXXXXXXXXXXXXX------------oo--XXXX--oooo-XXXXXXXXXXXX-y----XXXXXXXXXXXXXXXXX--------
SXXXXXXXXXXXXXXXXXXXXXXXXXXXXXXXXXXXXXXXXXXXXXXXXXXXXX----r----XXXXXXXXXXXXXXXXXXXXXXXXXX-------XXXX-------XXXXXXXXXXXXXXXXXXXXXXXXXXXXXXXXXXX--------
SXXXXXXXXXXXXXXXXXXXXXXXXXXXXXXXXXXXXXXXXXXXXXXXXXXXXXXXXXXXXXXXXXXXXXXXXXXXXXXXXXXXXXXXXXXXXXXXXXXXXXXXXXXXXXXXXXXXXXXXXXXXXXXXXXXXXXXXXXXXXXXXXXXXXX
