S----SSSSSSSSSSSSSSSSSSSSSSSSSSSSSSSSSSSSSSSSSSSSSSSSSSSSSSSSSSSSSSSSSSSSSSSSSSSSSSSSSSSSSSSSSSSSSSSSSSSSSSSSSSSSSSSSSSSSSSSSSSSSSSSSSSSSSSSSSSSSSSSSS
S----------SSSSSSSSSSSSSSSSSS-----SSSSSSSSSSSSSSSSSSSSSSSSSSSSSSSSSSSSSSSSSSSSSSSSSSSSSSSSSSSSSSSSSSSSSSSSSSSSS--------SSSSSSSSSSSSS-------SSSSSSSSSSS
S-----------------SSSSSSSSSSS------------------------SSSSSSSSSSSSSSSSSSSSSSSSSSSS--------SSSSSSSSSSSSSSSSSSSSSS--------------SSSSSSS-------SSSSS------
S---------------------------------------------------------------------------SSSSS--------SSSSSSSS-------SSSSSSS---------------------------------------
S-----------------------------------------------------------------------------------------------------------------------------------------------------
S-----------------------------------------------------------------------------------------------------------------------------------------------------
S-----------------------------------------------------------------------------------------------------------------------------------------------------
S-----------------------------------------------------------------------------------------------------------------------------------------------------
S------------------------------------------------------------------ooS----------ooSS------------------------------------------------------------------
S----------------------oooo---------oooo-------------------------------------------------------------------------------------------oooS----oSoo-------
S-------------------------------------------------------------------oo-----------ooooo----------------------------------------------------------------
S-------------ooo-----oooo----------oooo----oSoooo----------g----------r----------------------------------SSS------------ooooo----ooooo----ooooo------
S--------------r---XX--------oooo----g-------------XXXXXXXXXXXXXXXXXXXXXXX----XXXXXXXXX---ooooo--ooooo--------------------------k-y-----g--gg---------
SXXXXXXXXXXXXXXXXXXXXXXXXXXX-------XXXXXXXX-ooooo--XXXXXXXXXXXXXXXXXXXXXXX----XXXXXXXXX------------------ooo-----oo-----XXXXXXXXXXXXXXXXXXXXXXXXXXX---
SXXXXXXXXXXXXXXXXXXXXXXXXXXXXXXXXXXXXXXXXXX--y-----XXXXXXXXXXXXXXXXXXXXXXX----XXXXXXXXXXXXXXXXXXXXXXXXX-kr------r-----XXXXXXXXXXXXXXXXXXXXXXXXXXXXX---
SXXXXXXXXXXXXXXXXXXXXXXXXXXXXXXXXXXXXXXXXXXXXXXXXXXXXXXXXXXXXXXXXXXXXXXXXXXXXXXXXXXXXXXXXXXXXXXXXXXXXXXXXXXXXXXXXXXXXXXXXXXXXXXXXXXXXXXXXXXXXXXXXXXXXX
