S----SSSSSSSSSSSSSSSSSSSSSSSSSSSSSSSSSSSSSSSSSSSSSSSSSSSSSSSSSSSSSSSSSSSSSSSSSSSSSSSSSSSSSSSSSSSSSSSSSSSSSSSSSSSSSSSSSSSSSSSSSSSSSSSSSSSSSSSSSSSSSSSSS
S----SSSSSSSSSSS------SSSSS-------SSSSSSSSSSSSS---------------------SSSSSSSSSSSSSSSSSSSSSSSSSSSSSSSSSSSSSSSSSSSSSSSSSSSSSSSS-----------SSSSSSSSSSSSSSS
S----------SSSSS------SSSSS--------------SSSSSS-----------------------------------SSSSSSSSSSSSSSSSSSSSS--------SSSSSSSSSSSSS------------------SSSSSSSS
S----------SSSSS-------------------------SSSSSS-----------------------------------------SSSSSSSSSSSSSSS--------SSSSSSSSSSSSS------------------SSSSSSSS
S-----------------------------------------------------------------------------------------------------------------------------------------------------
S-----------------------------------------------------------------------------------------------------------------------------------------------------
S-----------------------------------------------------------------------------------------------------------------------------------------------------
S-----------------------------------------------------------------------------------------------------------------------------------------------------
S-------------------------------------------------------------------------------------ooSo-------------------------------SoooSo-----------oSoo--------
S-----------------------------------Sooooo------------------ooSS--------------------------------------------------------------------------------------
S------------oSooo-----oo----------------------------------------------------oooo---------------------------------------ooooo-------------ooo---------
S----------------------G----------oooooooo------------------oooo---------------r------------------------------oooSoo------------------------g---------
S--------------oo---XXXXXXX--------g----y------oo-----XXXXX-------------oo-XXXXXXX---XXXXXX-----oooo-------------------XXXXXXXXXX---g--XXXXXXXX------X
SXXXXXXXXXXX-----g--XXXXXXX------XXXXXXXXXX---r-------XXXXXXXXXXXXXX-k-----XXXXXXX---XXXXXXXXXX---y--------------------XXXXXXXXXXXXXXXXXXXXXXXX------X
SXXXXXXXXXXXXXXXXXXXXXXXXXX------XXXXXXXXXXXXXXXXXXXXXXXXXXXXXXXXXXXXXXXXXXXXXXXXXXXXXXXXXXXXXXXXXXXX---g--XX----------XXXXXXXXXXXXXXXXXXXXXXXX------X
SXXXXXXXXXXXXXXXXXXXXXXXXXXXXXXXXXXXXXXXXXXXXXXXXXXXXXXXXXXXXXXXXXXXXXXXXXXXXXXXXXXXXXXXXXXXXXXXXXXXXXXXXXXXXXXXXXXXXXXXXXXXXXXXXXXXXXXXXXXXXXXXXXXXXX
