S----SSSSSSSSSSSSSSSSSSSSSSSSSSSSSSSSSSSSSSSSSSSSSSSSSSSSSSSSSSSSSSSSSSSSSSSSSSSSSSSSSSSSSSSSSSSSSSSSSSSSSSSSSSSSSSSSSSSSSSSSSSSSSSSSSSSSSSSSSSSSSSSSS
S----SSSSSSSSSSSSSSSSSSSSSSSSSSSSSSSSSSSSSSSSS--------SSSSSSSSSSSSSSSSSSSSSSSSSS--------SSSSSSSSSSSSSSSSSSSSSSSSSSSSSSSSS--------SSSSSSSSSSS------SSSS
S----SSSSSSS---------------SSSSSSS-------SSSSS---------------------SSSSSSSSSSSSS--------SSSSSSSSSSSSSSSSSSSSSSSSSSSSSSSSS--------SSSSSS-----------SSSS
S--------------------------SSSSSSS-------SSSSS---------------------SSSSSSSSSSSSS--------SSSSSS-----SSSSSS--------SSSSSSSS--------SSSSSS-----------SSSS
S-----------------------------------------------------------------------------------------------------------------------------------------------------
S-----------------------------------------------------------------------------------------------------------------------------------------------------
S-----------------------------------------------------------------------------------------------------------------------------------------------------
S-----------------------------------------------------------------------------------------------------------------------------------------------------
S-----------------------------------------------------------------------------------oSooo------------------------oSoo------------------------oooo-----
S-------------------------------------------------------------------------ooooSo-----------------------------------------SSSoooo----------------------
S---------------------------------ooooSooo-------------------------------------------ooo-------------------------ooo------------------------oooooooo--
S------------------------------------------------------------oSSoooo---------------gy----g------------------------------ooooo--------SSSo----g--------
S--------------------------oo-------ooooo-----ooo-----------------------------kk--XXXXXXXXX----r---------------XXXXXXX-g-------------------XXXXXXXXXX-
SXXXXXXXXXXXX---oo-XXXXX---G-------------r-------------XXXXX-oooo--------XXXXXXXXXXXXXXXXXXXXXXXX--------ooo---XXXXXXXXXXXXXXXXXX--ooooooo-XXXXXXXXXX-
SXXXXXXXXXXXX------XXXXX--XXXXXXXXXXXXXXXXXXXXXXXX-----XXXXX---------XXXXXXXXXXXXXXXXXXXXXXXXXXXXXXXXXXX--k----XXXXXXXXXXXXXXXXXX----------XXXXXXXXXX-
SXXXXXXXXXXXXXXXXXXXXXXXXXXXXXXXXXXXXXXXXXXXXXXXXXXXXXXXXXXXXXXXXXXXXXXXXXXXXXXXXXXXXXXXXXXXXXXXXXXXXXXXXXXXXXXXXXXXXXXXXXXXXXXXXXXXXXXXXXXXXXXXXXXXXX
