S----SSSSSSSSSSSSSSSSSSSSSSSSSSSSSSSSSSSSSSSSSSSSSSSSSSSSSSSSSSSSSSSSSSSSSSSSSSSSSSSSSSSSSSSSSSSSSSSSSSSSSSSSSSSSSSSSSSSSSSSSSSSSSSSSSSSSSSSSSSSSSSSSS
S----SSSSS------------------SSSSSSSSSSSSS-------SSSSSSSSSSSSSSSSSSSSSSSSSSSSSSSSSSSSSSSSSSSSSSSSSSSSSS------SSSSSSSSSSSSSSSSSSSSSSSSSSSSSSSSSS------SS
S----SSSSS--------------------------------------------------SSSSSSSSSSSS---------------------------------------------------SSSSS--------SSSSSS------SS
S-----------------------------------------------------------SSSSSS---------------------------------------------------------SSSSS--------------------SS
S-----------------------------------------------------------------------------------------------------------------------------------------------------
S-----------------------------------------------------------------------------------------------------------------------------------------------------
S-----------------------------------------------------------------------------------------------------------------------------------------------------
S-----------------------------------------------------------------------------------------------------------------------------------------------------
S----------------oooo---------SoSSS----------------------SooS-----------------------------------------------------------------------------------------
S--------------------------------------ooo---------------------------------------------------------oSo--------------ooo-------------oooS--------------
S----------------------------ooooooo----------------------ooooo---------------------------------------------------------------------------------------
S------------------y---------R-r-----------------------------R----------ooo-----------------------oooo-----------oooooo-------------ooo-------oSo-----
S---------------XXXXXX------XXXXXXXXX------XXX---------XXXXXXXXXX-----------XX-------------ooo-----k----------------------ooo-XXXX--------------------
SXXXXXXXXXXXXX--XXXXXXXXXXXXXXXXXXXXXXXXXXXXXX---------XXXXXXXXXX--------oo-XXXXXX--------g------XXXXXX-----XXXXXXXXXXXX------XXXXXXXXXXXX----oooooo--
SXXXXXXXXXXXXX--XXXXXXXXXXXXXXXXXXXXXXXXXXXXXXXX----XXXXXXXXXXXXX---------g-XXXXXX---XXXXXXXXXX--XXXXXX-----XXXXXXXXXXXXXXXXXXXXXXXXXXXXXX------------
SXXXXXXXXXXXXXXXXXXXXXXXXXXXXXXXXXXXXXXXXXXXXXXXXXXXXXXXXXXXXXXXXXXXXXXXXXXXXXXXXXXXXXXXXXXXXXXXXXXXXXXXXXXXXXXXXXXXXXXXXXXXXXXXXXXXXXXXXXXXXXXXXXXXXX
