S----SSSSSSSSSSSSSSSSSSSSSSSSSSSSSSSSSSSSSSSSSSSSSSSSSSSSSSSSSSSSSSSSSSSSSSSSSSSSSSSSSSSSSSSSSSSSSSSSSSSSSSSSSSSSSSSSSSSSSSSSSSSSSSSSSSSSSSSSSSSSSSSSS
S----SSSSSSSSSSSSSSSSSSSS-------SSSSSSSSSSSSSSSSSSSSS--------SSSSSS-------SSSSSSSSSSSSSSSSSS--------------SSSSSSSSSSSSSSSSSSSSSSSSSSSSSSSSS-------SSSS
S----SSSSSSSSSSSSSSSSSSSS-------SSSSSSSS--------SSSSS--------SSSSSS-------SSSSSSSSSSSSSSSSSS----------------------------------SSSSSSSSSSSSS-------SSSS
S------------SSSSS--------------SSSSSSSS--------SSSSS--------SSSSSS-------SSSSSSSSSSSSS---------------------------------------SSSSSSSSSSSSS-----------
S-----------------------------------------------------------------------------------------------------------------------------------------------------
S-----------------------------------------------------------------------------------------------------------------------------------------------------
S-----------------------------------------------------------------------------------------------------------------------------------------------------
S-----------------------------------------------------------------------------------------------------------------------------------------------------
S---------------------------------------------------------------------------------------------------ooS-----------------------------------------------
S-----------------------------------------tt---------------------------------------------------------------ooSo----SoooSSS----------------------------
S----------------------------oo-----------tt------------oSoo----------------------------------------oo------------------------------------------------
S-------------------oooo--------r---------tt-----------------------------------------------------------------------ooooo-----kk-----------------------
S---------------------------XXXXXX------XXXXXX----XXX---ooo---------------------XXXXXXX------------XXXXXX-yK----------------XXXXXXX----XXX---XXX------
SXXXXXXXXXXX----------------XXXXXX---XXXXXXXXX--XXXXX----r-----XXXXXXXXXXXXXXXXXXXXXXXXXXXXX-----XXXXXXXXXXXXXXXXXXXXXXXXXXXXXXXXXX----XXX---XXXXXXXXX
SXXXXXXXXXXXXXXXXXX---r-----XXXXXXXXXXXXXXXXXX--XXXXXXXXXXXXXXXXXXXXXXXXXXXXXXXXXXXXXXXXXXXX-----XXXXXXXXXXXXXXXXXXXXXXXXXXXXXXXXXXXXXXXXX---XXXXXXXXX
SXXXXXXXXXXXXXXXXXXXXXXXXXXXXXXXXXXXXXXXXXXXXXXXXXXXXXXXXXXXXXXXXXXXXXXXXXXXXXXXXXXXXXXXXXXXXXXXXXXXXXXXXXXXXXXXXXXXXXXXXXXXXXXXXXXXXXXXXX---XXXXXXXXX
