S----SSSSSSSSSSSSSSSSSSSSSSSSSSSSSSSSSSSSSSSSSSSSSSSSSSSSSSSSSSSSSSSSSSSSSSSSSSSSSSSSSSSSSSSSSSSSSSSSSSSSSSSSSSSSSSSSSSSSSSSSSSSSSSSSSSSSSSSSSSSSSSSSS
S----SSSSSSSSSSSSSSSSSSSSSSSSSSSSSSSSSSSSSSSSSSSSSSSSSSSSSSSSSS------SSSSSSSSSSSSSS--------SSSSSSSSSSSSSSSSSSSSSSSSSSSSSSSSSSSSSSSSSSSSS-------SSSSSSS
S----------------------------SSSSSSSSSSSSSSSSSSSSSSSSSSSSSSSSSS------SSSSSSSSSSSSSS---------------SSSSSSSSSSSSSSSSSSSSSSSSS-----SSSSSSSS-------SSSSSSS
S----------------------------SSSSS-----SSSSSSSS-----SSSSSSSSSSS------------SSSSSSSS-------------------------------------------------------------------
S-----------------------------------------------------------------------------------------------------------------------------------------------------
S-----------------------------------------------------------------------------------------------------------------------------------------------------
S-----------------------------------------------------------------------------------------------------------------------------------------------------
S-----------------------------------------------------------------------------------------------------------------------------------------------------
S--------------------------------------------------------------ooSoo--oSoooS--------------------------------------------------------------------------
S-----------------------------------------------------------------------------------------------------------------------------------------------oooSo-
S-------------Soooo------------------------------------------ooooo------oo-----------------------------------------------------------oSoo-------------
S---------------------------oSo-----ooSSoooSo---------------------------------------------------oooSo---------oo----oSSSS-----------------------------
S-----------oooo---------------------------------------XXXXXXXXXXXXXXXXXXXXXXX--------XXXXXX--------------------------------XX------oooo---------rg---
SXXXXXXXXX--------y--------ooooooo----ooooo---XX----k--XXXXXXXXXXXXXXXXXXXXXXX-ooo----XXXXXX-oooooo---XXXXXXXXXXXX---ooooo--XX-----------------XXXXXXX
SXXXXXXXXXXXXXXXXXXX-----r----------------k---XXXXXXXXXXXXXXXXXXXXXXXXXXXXXXXX--------XXXXXX----------XXXXXXXXXXXX-----r----XX--XXXXXXXXXXXXXXXXXXXXXX
SXXXXXXXXXXXXXXXXXXXXXXXXXXXXXXXXXXXXXXXXXXXXXXXXXXXXXXXXXXXXXXXXXXXXXXXXXXXXXXXXXXXXXXXXXXXXXXXXXXXXXXXXXXXXXXXXXXXXXXXXXXXXXXXXXXXXXXXXXXXXXXXXXXXXX
