------------------------------------------------------------------------------------------------------------------------------------------------------
------------------------------------------------------------------------------------------------------------------------------------------------------
------------------------------------------------------------------------------------------------------------------------------------------------------
-----------------------------------------------------------------------------------------------------------------------------------------oooo---------
------------------------------------------------------------------------------------------------------------------------------------------------------
-----------------------------------------------------------------------------------------------------------------------------------------%%%%%--------
-----------------------------------------------------------------------------------------------------------------------------------------|||||--------
-----------------------------------------------------------------------------------------------------------------------------------------|||||--------
-------------------------------------------------------------------------------------------------------------------------------------%%%%%%|||--------
----------------------------------------ooSo-------------------oooS---------------------------------------------------oooS-----------|||||||||--------
---------------------oooo--------oo---------------------oo----------------------------------oooo--oooo-------------------------------|||||||||--------
---------------oo----------------Y--k--ooooo----ooooo---------oooooo----oooo--ooo---------y---------g---------ooooo------oo----k-----||||||r||--------
-----------------k-----------XXXXXXXXX-----------------XXXXXX----------------------------XXXXXXXXXXXXXX-----------------------XXXXXXXXXXXXXXXXXX------
XXXXXXXXXXXXXXXXXXXX----g-XXXXXXXXXXXXXXXXXXXXXXXXXXXXXXXXXXXXXXXXXXX-ooooo--XXXXXXXXXXXXXXXXXXXXXXXXXX-----ooooo----XXXXXXXXXXXXXXXXXXXXXXXXXXXXXXXX-
XXXXXXXXXXXXXXXXXXXXXXXXXXXXXXXXXXXXXXXXXXXXXXXXXXXXXXXXXXXXXXXXXXXXX--------XXXXXXXXXXXXXXXXXXXXXXXXXX-----r--------XXXXXXXXXXXXXXXXXXXXXXXXXXXXXXXXX
XXXXXXXXXXXXXXXXXXXXXXXXXXXXXXXXXXXXXXXXXXXXXXXXXXXXXXXXXXXXXXXXXXXXXXXXXXXXXXXXXXXXXXXXXXXXXXXXXXXXXXXXXXXXXXXXXXXXXXXXXXXXXXXXXXXXXXXXXXXXXXXXXXXXXX