S----SSSSSSSSSSSSSSSSSSSSSSSSSSSSSSSSSSSSSSSSSSSSSSSSSSSSSSSSSSSSSSSSSSSSSSSSSSSSSSSSSSSSSSSSSSSSSSSSSSSSSSSSSSSSSSSSSSSSSSSSSSSSSSSSSSSSSSSSSSSSSSSSS
S----SSSSSS------SSSSSSSSSSSSSSSSSSSSSSSSSSSSS-------SSSSSSS------SSSSSSSSSSSSSSSSSSSSSSSSSS-----SSSSSSSS------SSSSS--------SSSSS-------------SSSSSSSS
S------------------------SSSSS-----SSSSSSSSSSS-------SSSSSSS------SSSSSS-------------------------SSSSSSSS------SSSSS--------SSSSS-------------SSSSSSSS
S------------------------SSSSS----------SSSSSS--------------------SSSSSS-------------------------SSSSSSSS------SSSSS--------SSSSS-------------SSSSSSSS
S-----------------------------------------------------------------------------------------------------------------------------------------------------
S-----------------------------------------------------------------------------------------------------------------------------------------------------
S-----------------------------------------------------------------------------------------------------------------------------------------------------
S-----------------------------------------------------------------------------------------------------------------------------------------------------
S---------------------------ooooS-----------------------------------------------SooS------------------------ooSS--------------------------------------
S--------------------------------------ooo------------------------------------------------------------------------------------------------------------
S----------------------------ooo------------------------------------------------ooo------------------------ooooo---oo---------------------------------
S--------------------------y----k-------------------------oSooSo----------------g---k--------------ooooo------y-----k---------------------------------
S------------------------XXXXXXXXXXX----------------XXX---------------------XXXXXXXXXXX------------------XXXXXXXXXXXXXXX----tt--------------XXX---oo--
S------------------------XXXXXXXXXXXXXXXXXXXX---g---XXX-----ooooo-XXXXX-----XXXXXXXXXXX---ooo-----ooo----XXXXXXXXXXXXXXX----tt-------XXXX---XXX--gr---
SXXXXXXXXXX-----XXX---XXXXXXXXXXXXXXXXXXXXXXXXXXXXXXXXXXX---------XXXXX-----XXXXXXXXXXX-----y----------k-XXXXXXXXXXXXXXXXXXXXXXXXX---XXXX---XXXXXXXXXX
SXXXXXXXXXXXXXXXXXX---XXXXXXXXXXXXXXXXXXXXXXXXXXXXXXXXXXXXXXXXXXXXXXXXXXXXXXXXXXXXXXXXXXXXXXXXXXXXXXXXXXXXXXXXXXXXXXXXXXXXXXXXXXXXXXXXXXXXXXXXXXXXXXXX
