S----SSSSSSSSSSSSSSSSSSSSSSSSSSSSSSSSSSSSSSSSSSSSSSSSSSSSSSSSSSSSSSSSSSSSSSSSSSSSSSSSSSSSSSSSSSSSSSSSSSSSSSSSSSSSSSSSSSSSSSSSSSSSSSSSSSSSSSSSSSSSSSSSS
S---------SSSSSSSSSSSSSSSSSSSSSSSSSSSSSSSS-------SSSSSSSS------SSSSSSSSSSSSSSSSSSS--------------------SSSSSSSSSSSSSSSSSSSSSSSSSS-----SSSSSSSSSSSSSSSSS
S---------SSSSSSSSSSSSSSSSSSSSSSSS-------------------------------------------SSSSS--------------------SSSSSSSSSSSSSSSSSSSSSSSSSS-----SSSSSSSSSSSSSSSSS
S---------SSSSSSS------------SSSSS--------------------------------------------------------------------SSSSSSS--------------SSSSS-----SSSSSSSSSSSSSSS--
S-----------------------------------------------------------------------------------------------------------------------------------------------------
S-----------------------------------------------------------------------------------------------------------------------------------------------------
S-----------------------------------------------------------------------------------------------------------------------------------------------------
S-----------------------------------------------------------------------------------------------------------------------------------------------------
S---------------------------------------------------------oooSo---------------------------------------------------------------------------------------
S--------------------------------------------------------------------------------------ooSS------ooo---SSo--------------------------------------------
S---------------------------------------------------------ooo-----------------------------------------------------------------------------------------
S-----------------------g------------------------------------------------------oooo------oo-----ooo----oooooo---------oo------------------------------
S--------------XXXXXXXXXXX---oo----------XXXXXXXXX------XXXXXXXXX---------XX--r--g--XX--------g------------------------------------------tt------ooo--
S---------XXXXXXXXXXXXXXXX---------------XXXXXXXXX------XXXXXXXXXXXXXXXXXXXXXXXXXXXXXXXXXXXXXXXXXXXXXXXXXXXXXX--XXXXXXXXXXXXX------------tt-----------
SXXXXXXXXXXXXXXXXXXXXXXXXXXXXXXXXXXXX----XXXXXXXXX------XXXXXXXXXXXXXXXXXXXXXXXXXXXXXXXXXXXXXXXXXXXXXXXXXXXXXXXXXXXXXXXXXXXXXXXXXXX------tt----XXXXXXX
SXXXXXXXXXXXXXXXXXXXXXXXXXXXXXXXXXXXXXXXXXXXXXXXXXXXXXXXXXXXXXXXXXXXXXXXXXXXXXXXXXXXXXXXXXXXXXXXXXXXXXXXXXXXXXXXXXXXXXXXXXXXXXXXXXXXXXXXXXXXXXXXXXXXXX
