S----SSSSSSSSSSSSSSSSSSSSSSSSSSSSSSSSSSSSSSSSSSSSSSSSSSSSSSSSSSSSSSSSSSSSSSSSSSSSSSSSSSSSSSSSSSSSSSSSSSSSSSSSSSSSSSSSSSSSSSSSSSSSSSSSSSSSSSSSSSSSSSSSS
S----SSSSSSSSSSSSSSS------SSSSSSS-------SSSSSSSSSSSSSSSSSSSSSSSSSSSSSS------SSSSSSSSSSSSSSSSSSSSSSSSS------SSSSSSSSSSSSSSSSSSSSSSSSSSSSSSSSSSSSSSSS---
S----SSSSSSSSSSSSSSS------SSSSSSS-------SSSSSSSS------SSSSSSSSSSSSSSSS-----------SSSSS---------------------SSSSSSSSSSSSSSSSSSSSSSSSSSSSSSSSS----------
S----SSSSSSSS-------------SSSSSSS-------SSSSSSSS------SSSSSSSS--------------------------------------------------SSSSSS--------SSSSSSSSSSSSSS----------
S-----------------------------------------------------------------------------------------------------------------------------------------------------
S-----------------------------------------------------------------------------------------------------------------------------------------------------
S-----------------------------------------------------------------------------------------------------------------------------------------------------
S-----------------------------------------------------------------------------------------------------------------------------------------------------
S------------------------------------------------------------------ooSo-----------------------------------------------------------------------SSo-----
S------------oooo--------------------------------------oSSSooo-------------------SoSoSS---------------------------------------------------------------
S----------------------------------------------------------------------------*--------------ooSoo-----------oooooo---------------------oooo-----------
S------------oooo------------------------SSo-----ooo---ooooooo---------------*---ooooooo----------------------------------oooooSo-------------g-------
S------------rg-g-------*--------------------------------------Y-XXXXXXXXXXXXXX-----r-------ooooo-----------oooooo---XXXX-----------oooo----XXXXXXX---
S---------XXXXXXXX------*--*-----X--X------------ooo--XXXXXXXXXXXXXXXXXXXXXXXXXXXXXXXXXXXX----g-y--------------------XXXX----ooo------k-----XXXXXXXXXX
SXXXXXXXXXXXXXXXXX-----XXXXXXXXXXX--XXX---g-----------XXXXXXXXXXXXXXXXXXXXXXXXXXXXXXXXXXXXXXXXXXXXXXXXXXXXXXXXXXXXXXXXXXX---g------XXXXXXXXXXXXXXXXXXX
SXXXXXXXXXXXXXXXXXXXXXXXXXXXXXXXXX--XXXXXXXXXXXXXXXXXXXXXXXXXXXXXXXXXXXXXXXXXXXXXXXXXXXXXXXXXXXXXXXXXXXXXXXXXXXXXXXXXXXXXXXXXXXXXXXXXXXXXXXXXXXXXXXXXX