S----SSSSSSSSSSSSSSSSSSSSSSSSSSSSSSSSSSSSSSSSSSSSSSSSSSSSSSSSSSSSSSSSSSSSSSSSSSSSSSSSSSSSSSSSSSSSSSSSSSSSSSSSSSSSSSSSSSSSSSSSSSSSSSSSSSSSSSSSSSSSSSSSS
S-----------SSSSSSSSSSSSSSSSSSSSSS-----SSSSSSSSSSSSSSSSSS-------SSSSSSSSSSSSSSS--------SSSSSSSSSSS-----SSSSSSSS-------SSSSSSSSSSSSSSSSSSSSSSSSS-------
S----------------------------SSSSS----------SSSSSSSSSSSSS-----------------SSSSS---------------------------------------SSSSS-------SSSSSSS-------------
S-------------------------------------------SSSSSSSSSSSSS-------------------------------------------------------------------------SSSSSSS-------------
S-----------------------------------------------------------------------------------------------------------------------------------------------------
S-----------------------------------------------------------------------------------------------------------------------------------------------------
S-----------------------------------------------------------------------------------------------------------------------------------------------------
S-----------------------------------------------------------------------------------------------------------------------------------------------------
S----------------------------oSSo---ooooooo--------ooooo-------------------------ooo-----oSoo--------------------ooo----------------------------------
S-----------------------------------------------------------------------------------------------------------------------------------------------------
S--------------------------oooooo--ooooo----------oooo------------------------ooooooo-----oooooo--------------oooooo----------------------------------
S----------------------------------k-----------------------------------------------------------------------------r--r-----------------oooSo-----------
S--------------------XX--XXXXXXXXXXXXXXXXXXX-----XXXXXXXXXXX-----------------XXXXXXXXXXXXXXXXXXXX-ooo---Y----XXXXXXXXXX-------------------------ooooo-
SXXXXXXXXXXXX--------XXXXXXXXXXXXXXXXXXXXXXXXX---XXXXXXXXXXX------XXX---XXXXXXXXXXXXXXXXXXXXXXXXX------XXXXXXXXXXXXXXXXXXXXXXXXXXX--ooooooo------g--y-
SXXXXXXXXXXXXXXXXXXXXXXXXXXXXXXXXXXXXXXXXXXXXX---XXXXXXXXXXXXXXX--XXX---XXXXXXXXXXXXXXXXXXXXXXXXXXXXXXXXXXXXXXXXXXXXXXXXXXXXXXXXXX-----------XXXXXXXXX
SXXXXXXXXXXXXXXXXXXXXXXXXXXXXXXXXXXXXXXXXXXXXXXXXXXXXXXXXXXXXXXXXXXXXXXXXXXXXXXXXXXXXXXXXXXXXXXXXXXXXXXXXXXXXXXXXXXXXXXXXXXXXXXXXXXXXXXXXXXXXXXXXXXXXX
