S----SSSSSSSSSSSSSSSSSSSSSSSSSSSSSSSSSSSSSSSSSSSSSSSSSSSSSSSSSSSSSSSSSSSSSSSSSSSSSSSSSSSSSSSSSSSSSSSSSSSSSSSSSSSSSSSSSSSSSSSSSSSSSSSSSSSSSSSSSSSSSSSSS
S----SSSSSSS--------SSSSSSSSSSSSSSSSSSSSSSSSSSSSSSSSSS------SSSSSSSSSSSSSSSSSSSSSSSSSSSSSSSSSSSSSSSSSSSSSSSSSSSSSSSSSSSSSSSSS--------------------SSSSS
S----SSSSSSS--------SSSSSSSSSSSSSSSSSSSSSSSSSSSSS------------------------------SSSSSSSSSSSS---------------------SSSSSSSSSSSSS--------------------SSSSS
S-------------------SSSSSSSS--------SSSSSSSSSSSSS------------------------------SSSSSSSSSSSS---------------------SSSSSSSS------------------------------
S-----------------------------------------------------------------------------------------------------------------------------------------------------
S-----------------------------------------------------------------------------------------------------------------------------------------------------
S-----------------------------------------------------------------------------------------------------------------------------------------------------
S-----------------------------------------------------------------------------------------------------------------------------------------------------
S--------------SoSoSoSo------------------------------------------------------------------------ooo----------------------------------------------------
S-------------------------------ooSSoo-----------------SoSooo------------------Soo----------------------------ooo------oooS-----oSo---oSS-------------
S-------------ooooooo---------------------------------------------------------------------------oo----------------------------------------------------
S--------------y-----Y------------oooo-------oSSSooo---oooo-----------------------------oSS--------------------------ooooo-------ooo------------------
S------------XXXXXXXXXXXXXXXXX------------------------------r------------------y--k----------XXXXXXX----XXXXX--------y-y--------------k---------------
S------------XXXXXXXXXXXXXXXXXXXXXXXXXXXXXXX-oooo----XXXXXXXXXXXXX----------XXXXXXXXX--------XXXXXXX----XXXXXXXXXXXXXXXXXXXXXXXXXXXXXXXXXXX----oo---XX
S---------XXXXXXXXXXXXXXXXXXXXXXXXXXXXXXXXXX---------XXXXXXXXXXXXXXXXXX-----XXXXXXXXX-----r--XXXXXXXXXXXXXXXXXXXXXXXXXXXXXXXXXXXXXXXXXXXXXX---------XX
SXXXXXXXXXXXXXXXXXXXXXXXXXXXXXXXXXXXXXXXXXXXXXXXXXXXXXXXXXXXXXXXXXXXXXXXXXXXXXXXXXXXXXXXXXXXXXXXXXXXXXXXXXXXXXXXXXXXXXXXXXXXXXXXXXXXXXXXXXXXXXXXXXXXXX
