S----SSSSSSSSSSSSSSSSSSSSSSSSSSSSSSSSSSSSSSSSSSSSSSSSSSSSSSSSSSSSSSSSSSSSSSSSSSSSSSSSSSSSSSSSSSSSSSSSSSSSSSSSSSSSSSSSSSSSSSSSSSSSSSSSSSSSSSSSSSSSSSSSS
S---------SSSSSSSSSSSSSSSSSSSSSSSSSSS------SSSSSSSSSSSSSSSSSSS-------SSSSSSSSSSSSSSSSSSSSSSSSSSSSSSSSSSSSSSSSSSSSSS--------SSSSSSSSSSSSSSSSSSSSSSSS---
S---------------SSSSSSSSSSSSSSSSSSSSS------SSSSSSSSSSSSSSSSSSS-------SSSSSSSSSSSSSS------SSSSSS------SSSSSSSSSSSSSS--------SSSSS--------SSSSSSSSSSS---
S-----------------------SSSSSS-------------SSSSSSSSSSSSSSSSSSS-------SSSSSSSSSSSSSS------SSSSSS------SSSSSS----------------SSSSS-------------SSSSSS---
S-----------------------------------------------------------------------------------------------------------------------------------------------------
S-----------------------------------------------------------------------------------------------------------------------------------------------------
S-----------------------------------------------------------------------------------------------------------------------------------------------------
S-----------------------------------------------------------------------------------------------------------------------------------------------------
S-----------------------------------------------------------------------------------------------------------------------------------------------------
S--------------oSSo-------------SoSSo-----------------------------------------------------------------SSSS--------------------------------------------
S-----------------------------------------ooSo------ooSo--------oSoo-------------------------------------------oSoSo---------------oSS------------oo--
S--------------oooo---------------ooo-------------------------------------oo------------------------oooooooo------------------------------------------
S----------------------------------kK---ooooo------ooooo--------ooooo-----g------oooo-----------y-----r-k------ooooo-------oo----ooooo--------XXXXXXXX
S-----------XXXXXXXXXXX-------XXXXXXXX------y----------------rr------r-XXXXXXXX-----r-------XXXXXXXXXXXXXXXXX------g--XX----------------------XXXXXXXX
SXXXXXXXXXXXXXXXXXXXXXX----y--XXXXXXXXXXXXXXXXXXXXXXXXXXXXXXXXXXXXXXXXXXXXXXXXXXXXXXXX------XXXXXXXXXXXXXXXXXXXXXXXXXXXXXXXXXXXXXXXXXXXXX-----XXXXXXXX
SXXXXXXXXXXXXXXXXXXXXXXXXXXXXXXXXXXXXXXXXXXXXXXXXXXXXXXXXXXXXXXXXXXXXXXXXXXXXXXXXXXXXXXXXXXXXXXXXXXXXXXXXXXXXXXXXXXXXXXXXXXXXXXXXXXXXXXXXXXXXXXXXXXXXX
