S----SSSSSSSSSSSSSSSSSSSSSSSSSSSSSSSSSSSSSSSSSSSSSSSSSSSSSSSSSSSSSSSSSSSSSSSSSSSSSSSSSSSSSSSSSSSSSSSSSSSSSSSSSSSSSSSSSSSSSSSSSSSSSSSSSSSSSSSSSSSSSSSSS
S----SSSSSSSSSSSSSSSSSSSSSSSSSSSSSSSSSSSS-------SSSSS-----SSSSSS-------------SSSSSSS------SSSSSSSSSSSSS-----------SSSSSSSSSSSS------SSSSSS--------SSSS
S---------------SSSSSSSSSSS-------SSSSSSS-------SSSSS-----SSSSSS-------------SSSSSSS------SSSSSSSSSSSSS-----------SSSSSSSSSSSS------SSSSSS------------
S--------------------SSSSSS-------------------------------SSSSSS--------------------------SSSSSSSSSSSSS-----------SSSSSSSSSSSS------SSSSSS------------
S-----------------------------------------------------------------------------------------------------------------------------------------------------
S-----------------------------------------------------------------------------------------------------------------------------------------------------
S-----------------------------------------------------------------------------------------------------------------------------------------------------
S-----------------------------------------------------------------------------------------------------------------------------------------------------
S---------------------Soo----------------------------------------------------------------------------------------------------------ooSooo-------------
S-------------------------------------------------------------------------------------oSoo------------------------------------------------------------
S------------ooo-----oooo--oSoooSoo-------------------------------ooooo--------------------------------------------------oooo--------ooo--------------
S-------------------------------------------------------------------------ooSooooo-----ooo---------------------------------------------g--------------
S------------ooo----XXXXXX--oooo-------XXX---------XX-----------oooo----------------------------------------XXXXXXXXX--oooo-------XXXXXXXXX-------XXXX
S-------------------XXXXXX-Ky-g-k---XXXXXX-------XXXXXX---------------y--oooooo----XXXXXXXXXX-ooooooo--XXXXXXXXXXXXXX---y---------XXXXXXXXXXXXXXXXXXXX
S----------XXXXXXXXXXXXXXXXXXXXXXXXXXXXXXXXXXXXXXXXXXXXXXXXX--XXXXXXXXXX---y-------XXXXXXXXXX----------XXXXXXXXXXXXXXXXXXXXXXXX---XXXXXXXXXXXXXXXXXXXX
SXXXXXXXXXXXXXXXXXXXXXXXXXXXXXXXXXXXXXXXXXXXXXXXXXXXXXXXXXXXXXXXXXXXXXXXXXXXXXXXXXXXXXXXXXXXXXXXXXXXXXXXXXXXXXXXXXXXXXXXXXXXXXXXXXXXXXXXXXXXXXXXXXXXXX
