S----SSSSSSSSSSSSSSSSSSSSSSSSSSSSSSSSSSSSSSSSSSSSSSSSSSSSSSSSSSSSSSSSSSSSSSSSSSSSSSSSSSSSSSSSSSSSSSSSSSSSSSSSSSSSSSSSSSSSSSSSSSSSSSSSSSSSSSSSSSSSSSSSS
S----SSSSSSSSSSSSSSSSSSSSSSSSSSSSSSSSSSSSSSSSSSSSSSSSSSSSSSSSSS-------SSSSSSSSSSSSSSSSSSSSSS--------------SSSSSSSSSSSSSSSSSSSSSSSSSSSSSSSSSSSSSSSSSSSS
S----------SSSSSSSS-------SSSSSSSSSSSS-------SSSSSSSSSSSSSSSSSS-------SSSSSSS-------SSSSSSSS--------------SSSSSSSS---------------SSSSS------SSSSSSSSSS
S----------SSSSSSSS----------------------------------SSSSS------------SSSSSSS--------------------------------------------------------------------SSSSS
S-----------------------------------------------------------------------------------------------------------------------------------------------------
S-----------------------------------------------------------------------------------------------------------------------------------------------------
S-----------------------------------------------------------------------------------------------------------------------------------------------------
S-----------------------------------------------------------------------------------------------------------------------------------------------------
S-------------------SSSo----------------------------oooo--------oSSo------Soo------------------------oooo---------------------------------------------
S---------------------------------------------------------------------------------------------oooS-----------------------------------------------Soo--
S--------------------oooooo--------------------------ooooo------oooo------oooo-----------------------oo----oSoSooooo----------------oo----------------
S-----------------g-------r---------------SoSoSoo------------------g--------------------------oo------------------------------------R------------oooo-
S----------------XXXXXXXXXXX----------XX-----------XXXXXXXX----XXXXXXXXXXXXXXXXX--------------------XXXXXX----ooo-------------r---XXXXXX--------------
S----------------XXXXXXXXXXX----------XX----ooo----XXXXXXXXXXXXXXXXXXXXXXXXXXXXX-oooo------XXXXXXXXXXXXXXX--r--k------------XXXXXXXXXXXX-------XXXXXXX
SXXXXXXXXXXXXX---XXXXXXXXXXX----XXXX--XX-----------XXXXXXXXXXXXXXXXXXXXXXXXXXXXX-----------XXXXXXXXXXXXXXXXXXXXXXXXXX--r--R-XXXXXXXXXXXXXX---XXXXXXXXX
SXXXXXXXXXXXXXXXXXXXXXXXXXXXXXXXXXXXXXXXXXXXXXXXXXXXXXXXXXXXXXXXXXXXXXXXXXXXXXXXXXXXXXXXXXXXXXXXXXXXXXXXXXXXXXXXXXXXXXXXXXXXXXXXXXXXXXXXXX---XXXXXXXXX
