S----SSSSSSSSSSSSSSSSSSSSSSSSSSSSSSSSSSSSSSSSSSSSSSSSSSSSSSSSSSSSSSSSSSSSSSSSSSSSSSSSSSSSSSSSSSSSSSSSSSSSSSSSSSSSSSSSSSSSSSSSSSSSSSSSSSSSSSSSSSSSSSSSS
S----------SSSSSSSSSSSSS----------SSSSSS--------SSSSSSSSSSSSSSSSSSSSSSSSSSSSSSSSSSSSSSSS-----SSSSSSSSSSSSSSSSSS-------SSSSSSSSSSSSSSSSSSSSSSSSSSSSSS--
S----------SSSSSSSSSSSSS------------------------SSSSSSSS--------------------SSSSSSSSSSSS-----SSSSSSSSSSSSSSSSSS-------SSSSSSSSSSSS-------SSSSS--------
S---------------------------------------------------------------------------SSSSSSSSSSSS--------------------------------------------------------------
S-----------------------------------------------------------------------------------------------------------------------------------------------------
S-----------------------------------------------------------------------------------------------------------------------------------------------------
S-----------------------------------------------------------------------------------------------------------------------------------------------------
S-----------------------------------------------------------------------------------------------------------------------------------------------------
S------------------------------------------oSoo--------------------------oooooS-----------------------------------------------SSo---------------------
S----------------oooooSo------------------------------------------ooSS---------------------------------------oSoooSS---------------------------oooo---
S------------------------------------------ooo---------------------------ooooooooo--------------------------------------------ooo----oooooSo----------
S----------------ooooo---------------------r--r----------------ooooooo---y--y--------------------------------ooooo------------Gr--------------oooooo--
S-------------------k------XX-y---y-XXXXXXXXXXXXXX-----------------yk---XXXXXXXXXXX---------------XX----oo--------k--------XXXXXXXXX--oooooo--k-------
S---------------XXXXXXXXX--XXXXXXXXXXXXXXXXXXXXXXXXXXXX---oo--XXXXXXXXXXXXXXXXXXXXX-oooo----------XXXX---r--XXXXXXXXXXXXXXXXXXXXXXXX-----gk--XXXXXXXXX
S-----------XXXXXXXXXXXXX--XXXXXXXXXXXXXXXXXXXXXXXXXXXX-------XXXXXXXXXXXXXXXXXXXXX-r---y---XXXXXXXXXXXXXXXXXXXXXXXXXXXXXXXXXXXXXXXXXXXXXXXXXXXXXXXXXX
SXXXXXXXXXXXXXXXXXXXXXXXXXXXXXXXXXXXXXXXXXXXXXXXXXXXXXXXXXXXXXXXXXXXXXXXXXXXXXXXXXXXXXXXXXXXXXXXXXXXXXXXXXXXXXXXXXXXXXXXXXXXXXXXXXXXXXXXXXXXXXXXXXXXXX
