S----SSSSSSSSSSSSSSSSSSSSSSSSSSSSSSSSSSSSSSSSSSSSSSSSSSSSSSSSSSSSSSSSSSSSSSSSSSSSSSSSSSSSSSSSSSSSSSSSSSSSSSSSSSSSSSSSSSSSSSSSSSSSSSSSSSSSSSSSSSSSSSSSS
S----SSSSSSSSSSSSSSSSSSSSSSSSSSSSSSSSSSSSSSSSSSSSSSSSS-------SSSSSSSSSSSSSSSSSSSSSSSSSSSSSSSS-----SSSSS------SSSSSSSSSSSSSSSS---------------------SSSS
S----SSSSS-----SSSSSSSSSSSSSS------------SSSSSS--------------------SSSSSSSS------SSSSS------------SSSSS------SSSSSSSSSSSSSSSS---------------------SSSS
S--------------SSSSSS----------------------------------------------SSSSSSSS------SSSSS------------SSSSS------SSSSSSSS-----------------------------SSSS
S-----------------------------------------------------------------------------------------------------------------------------------------------------
S-----------------------------------------------------------------------------------------------------------------------------------------------------
S-----------------------------------------------------------------------------------------------------------------------------------------------------
S-----------------------------------------------------------------------------------------------------------------------------------------------------
S----------------------------------ooSoo--------------------Sooooo------------------------------SSSoSSo------------------Soo--------------------------
S------------------------SSoSo------------------------------------------oSS---------------------------------------------------------------------------
S----------------------------------ooooooo-----------------oooooooo-------------------------------oo----------------------ooo-----SoSooo--------------
S-------------------------ooooo--------k-------oooSoo------g------g---oooo-------------------------y--------------oo---------r------------------------
SXXXXXXXXXXXX---------------------XXXXXXXXXX--------------XXXXXXXXXX---y-----XXXX--ooo-----XXXXXXXXXXXXXXXXX-----------XXXXXXXX-ooooooo---------------
SXXXXXXXXXXXX----XXXXXXXXXXXXXXXXXXXXXXXXXXX-ooooooo------XXXXXXXXXXXXXXXXXXXXXXX----g-XXXXXXXXXXXXXXXXXXXXX-----XXXXXXXXXXXXXX-----------------------
SXXXXXXXXXXXX----XXXXXXXXXXXXXXXXXXXXXXXXXXX-----------XXXXXXXXXXXXXXXXXXXXXXXXXXXXXXXXXXXXXXXXXXXXXXXXXXXXX-----XXXXXXXXXXXXXXXXXXXXXXXX-------XXXXXX
SXXXXXXXXXXXXXXXXXXXXXXXXXXXXXXXXXXXXXXXXXXXXXXXXXXXXXXXXXXXXXXXXXXXXXXXXXXXXXXXXXXXXXXXXXXXXXXXXXXXXXXXXXXXXXXXXXXXXXXXXXXXXXXXXXXXXXXXXXXXXXXXXXXXXX
