S----SSSSSSSSSSSSSSSSSSSSSSSSSSSSSSSSSSSSSSSSSSSSSSSSSSSSSSSSSSSSSSSSSSSSSSSSSSSSSSSSSSSSSSSSSSSSSSSSSSSSSSSSSSSSSSSSSSSSSSSSSSSSSSSSSSSSSSSSSSSSSSSSS
S----------SSSSSSSSSSSS------SSSSS------SSSSSSSSSSSSSSSSSSSSSSSSSSS-------------SSSSS------SSSSSSSSSSSSSSSSSSSSSSSSSS------------SSSSSSSSSSSSSSSSSSSSS
S----------SSSSSSSSSSSS------SSSSS------------SSSSS--------SSSSSSSS-------------SSSSS------------------SSSSSSS-------------------SSSSSS-----SSSSS-----
S-------------------------------------------------------------------------------SSSSS------------------SSSSSSS-------------------SSSSSS---------------
S-----------------------------------------------------------------------------------------------------------------------------------------------------
S-----------------------------------------------------------------------------------------------------------------------------------------------------
S-----------------------------------------------------------------------------------------------------------------------------------------------------
S-----------------------------------------------------------------------------------------------------------------------------------------------------
S---------------------------------------------------oSoSSS--------------------------------------------------------------------------------------------
S---------------Sooo----------------------------------------------------------------------------------------------------------------------------------
S----------------------------------------------------oooooo--------Soooo-------------oo------------oooSoooo--------------------------------------oooo-
S---------------ooooo-------------------------------y-k---g----------------------------g----------------------ooSo-----------------ooo--oo------------
S----------------g-r-----------XXXX-------oo-------XXXXXXXXX--------oo--------------XXXXXX------------ooooo-------------------------------------XXXXXX
S------------XXXXXXXXXXX-------XXXX----------g-----XXXXXXXXXXXXX-kY-y---------------XXXXXX----g--------------oooo-----------XXXXXXXXXXXXXXXXXX--XXXXXX
SXXXXXXXXXXXXXXXXXXXXXXXXXXXXXXXXXXXXXXXXXXXXXXX---XXXXXXXXXXXXXXXXXXXXXXX------XXXXXXXXXXXXXXXXXXXXXXXXXXXX----y----XXXXXXXXXXXXXXXXXXXXXXXXX--XXXXXX
SXXXXXXXXXXXXXXXXXXXXXXXXXXXXXXXXXXXXXXXXXXXXXXXXXXXXXXXXXXXXXXXXXXXXXXXXXXXXXXXXXXXXXXXXXXXXXXXXXXXXXXXXXXXXXXXXXXXXXXXXXXXXXXXXXXXXXXXXXXXXXXXXXXXXX
