S----SSSSSSSSSSSSSSSSSSSSSSSSSSSSSSSSSSSSSSSSSSSSSSSSSSSSSSSSSSSSSSSSSSSSSSSSSSSSSSSSSSSSSSSSSSSSSSSSSSSSSSSSSSSSSSSSSSSSSSSSSSSSSSSSSSSSSSSSSSSSSSSSS
S----SSSSSSSS-------SSSSSSSSSSSSSSSSSSSSS------SSSSSSSSSSSS-------SSSSSSSSSSSSSSSSSSSSSSSSSSSSSSSSSSSSSSSSSSSSSSSSSSSSSSSSSSSSSSSSSSSSSSSSSSSS------SS
S------------------------SSSSSSSSSSSSSSSS------SSSSSSSSSSSS-------SSSSSSSSSSSSSSSSSS------SSSSSS---------------------SSSSSSSSSSSSS------------------SS
S------------------------SSSSSSSSSSSSSSSS------SSSSSSSSSSSS-------SSSSS-------------------SSSSSS---------------------SSSSSS---------------------------
S-----------------------------------------------------------------------------------------------------------------------------------------------------
S-----------------------------------------------------------------------------------------------------------------------------------------------------
S-----------------------------------------------------------------------------------------------------------------------------------------------------
S-----------------------------------------------------------------------------------------------------------------------------------------------------
S-----------------------------------------------------------------------------------------------------------------------------------------------------
S----------ooooo----------------------------------ooo-----------------------------------Soo-----------------------------------------------------------
S----------------------------------------------------------------------------------------------oSSo-------------oSSooSSoo----------------ooSSSooS-----
S-----------------ooo---------------------oooo-----ooo----------------------ooS-------ooooo----------------------------------------oSS----------------
SXXXXXXXXX--------g-----------XXX---------------------------------------------------------------oooo--------------ooooooo-------------------oooooo-XXX
SXXXXXXXXXXXXXXXXXXXXXXXXXXX--XXX-------ooooo---XXXXXXX---oooooo-----------ooooooo-XXXXXXXXXXX-k-r---g-------XX------------ooo----oooo----y-----gy-XXX
SXXXXXXXXXXXXXXXXXXXXXXXXXXX--XXX--XXXX---------XXXXXXX------k-y----XXXXX--r-------XXXXXXXXXXXXXXXXXXXX------XXXXXXXXXXXXX---gg---------XXXXXXXXXXXXXX
SXXXXXXXXXXXXXXXXXXXXXXXXXXXXXXXXXXXXXXXXXXXXXXXXXXXXXXXXXXXXXXXXXXXXXXXXXXXXXXXXXXXXXXXXXXXXXXXXXXXXXXXXXXXXXXXXXXXXXXXXXXXXXXXXXXXXXXXXXXXXXXXXXXXXX
