S----SSSSSSSSSSSSSSSSSSSSSSSSSSSSSSSSSSSSSSSSSSSSSSSSSSSSSSSSSSSSSSSSSSSSSSSSSSSSSSSSSSSSSSSSSSSSSSSSSSSSSSSSSSSSSSSSSSSSSSSSSSSSSSSSSSSSSSSSSSSSSSSSS
S---------SSSSSS--------SSSSSSSSSSSSSSSSSSSSSSSSSSSSSS-------SSSSS-----SSSSSSSSSSSSSSSSSSSSSSSSSS-------SSSSSSSSSSSSSSSSSSSSS------SSSSSS-------------
S---------SSSSSS--------SSSSSSSSSSSSSSSSSS------SSSSSS-------SSSSS-----SSSSSSSSSSSSS----------------------------SSSSSSSSSSSSS------SSSSSS-------------
S---------SSSSSS--------SSSSSSS-----------------SSSSSS-------SSSSS-----SSSSSSSS---------------------------------SSSSSS-------------SSSSSS-------------
S-----------------------------------------------------------------------------------------------------------------------------------------------------
S-----------------------------------------------------------------------------------------------------------------------------------------------------
S-----------------------------------------------------------------------------------------------------------------------------------------------------
S-----------------------------------------------------------------------------------------------------------------------------------------------------
S-------------------------------------------------------------------ooooo-------------------------ooooo--------------------------------------SooS-----
S-----------------------------------------------------------------------------------------------------------------------------------------------------
S----------------ooo------ooo---------------------------Sooo-----------oo--------------------------oo-------ooS----------ooSoo---------------ooooo----
S---------------------------------------------------------------------------ooo-------------------k--g------------------------------------------------
S------------XXXXXXXXXXXXXXXXXXXXXXXX------------------oooo--------XXXXXXX------XXXXXXXXXX-------XXXXXXX----ooo---XXXXX-ooooooo---------XXXXXXXXXXXX--
S------------XXXXXXXXXXXXXXXXXXXXXXXX---oo-------------g---g-g-----XXXXXXX------XXXXXXXXXX--ooo--XXXXXXX---Y------XXXXX------r----XXXXXXXXXXXXXXXXXX--
SXXXXXXXXXXXXXXXXXXXXXXXXXXXXXXXXXXXX-----------------XXXXXXXXX----XXXXXXX----g-XXXXXXXXXX-------XXXXXXXXXXXXXXXXXXXXXXXXXXXXXXXXXXXXXXXXXXXXXXXXXXXXX
SXXXXXXXXXXXXXXXXXXXXXXXXXXXXXXXXXXXXXXXXXXXXXXXXXXXXXXXXXXXXXXXXXXXXXXXXXXXXXXXXXXXXXXXXXXXXXXXXXXXXXXXXXXXXXXXXXXXXXXXXXXXXXXXXXXXXXXXXXXXXXXXXXXXXX
