S----SSSSSSSSSSSSSSSSSSSSSSSSSSSSSSSSSSSSSSSSSSSSSSSSSSSSSSSSSSSSSSSSSSSSSSSSSSSSSSSSSSSSSSSSSSSSSSSSSSSSSSSSSSSSSSSSSSSSSSSSSSSSSSSSSSSSSSSSSSSSSSSSS
S----SSSSSSSSSSSSSSSSSSSSSSSSSSSSSSSSSSSSSSSSSSSS--------SSSSSSSSSSSSSSSSSSSSSSSSSSSSSSSSSSSSSSSSSSSSSS---------------SSSSSSSSSSSS-----SSSSSSSSSSSSSSS
S----SSSSSS------SSSSSSSSSSSSSSSSSSSSSSSSSSSSSSSS--------SSSSSSSSSSSSSSSSSSSSSSSSSSSSSSSS--------SSSSSS---------------SSSSSSSSSSSS-------------SSSSSSS
S----SSSSSS--------------------------------SSSSSS--------------SSSSSSSSSSSSSSSSSSSSSSSSSS-----------------------------SSSSSSSSSSSS-------------SSSSSSS
S-----------------------------------------------------------------------------------------------------------------------------------------------------
S-----------------------------------------------------------------------------------------------------------------------------------------------------
S-----------------------------------------------------------------------------------------------------------------------------------------------------
S-----------------------------------------------------------------------------------------------------------------------------------------------------
S-------------------------------------------------------------------------------------------------------------------ooo-------------------------------
S--------------------------------------------------ooSooSooo--ooS----------------------------------------------------------------------------SSoSSo---
S-------------------ooSo---------------------oSoo-------------------------------------------oSo---------------------ooo------Sooooo-------------------
S-----------------------------------------------------ooooo----------------------------------------------------------------------------------oooooo---
S--------------------ooooo----------------oooo-----------r----------XXXXXXX---ooo--------------------y------oo---XXXXXXXXX--ooooo-----------r---------
S----------XXX----------rr-----XXXXXXXX-------k---XXXXXXXXXXXXXXXXXXXXXXXXX-----y-------------gk-XXXXXXX---r-----XXXXXXXXX------g--------XXXXXXXXXXX--
SXXXXXXXXXXXXX----XXXXXXXXXXXXXXXXXXXXX--XXXXXXXXXXXXXXXXXXXXXXXXXXXXXXXXXXXXXXXXX----XXXXXXXXXXXXXXXXXXXXXXXXXXXXXXXXXXXXXXXXXXXXXX-----XXXXXXXXXXXXX
SXXXXXXXXXXXXXXXXXXXXXXXXXXXXXXXXXXXXXXXXXXXXXXXXXXXXXXXXXXXXXXXXXXXXXXXXXXXXXXXXXXXXXXXXXXXXXXXXXXXXXXXXXXXXXXXXXXXXXXXXXXXXXXXXXXXXXXXXXXXXXXXXXXXXX
