------------------------------------------------------------------------------------------------------------------------------------------------------
------------------------------------------------------------------------------------------------------------------------------------------------------
------------------------------------------------------------------------------------------------------------------------------------------------------
------------------------------------------------------------------------------------------------------------------------------------------------------
------------------------------------------------------------------------------------------------------------------------------------------------------
------------------------------------------------------------------------------------------------------------------------------------------------------
------------------------------------------------------------------------------------------------------------------------------------------------------
------------------------------------------------------------------------------------------------------------------------------------------------------
--------------------------------------------------------------------------------------------oSSSooo---------------------------------------------------
-----------------------------------------------------------------------------------------------------------------------------------------------oooSoo-
---------------------oSooS-------%%%%-------------------------Tt---------ooo----------------oooooo----------------------------------------------------
--------------ooSo---------------|k||-------------------------Tt-----------------------------gg---g----------------------oSS-----------------ooooooo--
-----------------------ooo----XXXXXXXXXX------------------XXXXXXXXXXXXXXXXXXXXX--XXXX-ooo--XXXXXXXXX-------XXXXX----oo--------------y-----------------
--------------ooooo--------r--XXXXXXXXXX------------------XXXXXXXXXXXXXXXXXXXXX--XXXX--r---XXXXXXXXX-------XXXXX--------ooooo-----XXXXXXX---XXXXXXXXXX
XXXXXXXXXX-----y----XXXXXXXXXXXXXXXXXXXXXXXXX--XXXXXXX--XXXXXXXXXXXXXXXXXXXXXXX--XXXXXXXXXXXXXXXXXXXXXXX---XXXXXXXXXXXX-----------XXXXXXXXXXXXXXXXXXXX
XXXXXXXXXXXXXXXXXXXXXXXXXXXXXXXXXXXXXXXXXXXXX--XXXXXXX--XXXXXXXXXXXXXXXXXXXXXXXXXXXXXXXXXXXXXXXXXXXXXXXXXXXXXXXXXXXXXXXXXXXXXXXXXXXXXXXXXXXXXXXXXXXXXX