S----SSSSSSSSSSSSSSSSSSSSSSSSSSSSSSSSSSSSSSSSSSSSSSSSSSSSSSSSSSSSSSSSSSSSSSSSSSSSSSSSSSSSSSSSSSSSSSSSSSSSSSSSSSSSSSSSSSSSSSSSSSSSSSSSSSSSSSSSSSSSSSSSS
S----SSSSSSSSSSSSSSSSSSSSSSSSSSSSSSSSSSSSSSSSSSSSSSSSSSSSSSSSSS--------SSSSSSSSSSSSSSSSSSSSSSSSSSSSSSSSSSSSSSSSSSSSSSSSSSSSSSSSSSSSSSSSSSS------------
S----------SSSSSSSS-------SSSSSSSSSSSSSSSSSSSSSSSSSSSSSSSSSSSSS--------SSSSSSS--------------------SSSSSSSSSSSSSSSSSSSSSSSSSSS-----SSSSSSSS------------
S-------------------------SSSSSSSSSSSSSSS-------SSSSSSSS---------------SSSSSSS----------------------------------------SSSSSSS-----SSSSSSSS------------
S-----------------------------------------------------------------------------------------------------------------------------------------------------
S-----------------------------------------------------------------------------------------------------------------------------------------------------
S-----------------------------------------------------------------------------------------------------------------------------------------------------
S-----------------------------------------------------------------------------------------------------------------------------------------------------
S-----------------------------------------------------------------------oSSo------ooSoo---------------------------------------------------------------
S----------------------------ooSo---------------oSSooSo-----------------------------------------------------------------------------------------------
S-------------ooooo---------------------------------------------------ooooo--------ooooo--------------------------------------------------------------
S--------------------------ooo----------oSoooo----oooo---------------k--r-----------------oSo--------------------------oo--oooo--------ooo------------
S----------ooooooo--XXXXXX----------------------k-------------------XXXXXXXXX---XXXXXXXXX-----------------------------------------------y--XXX--------
S-----------------R-XXXXXXXXXXXXXX-----oooo----XXXXXXXXXX-----------XXXXXXXXXXXXXXXXXXXXX--ooo-------oooooo----ooo-XXXXXXXXXXXXX--XXXXXXXXXXXX---y--XX
S---------XXXXXXXXXXXXXXXXXXXXXXXX----k-----k--XXXXXXXXXXXXXXX---k--XXXXXXXXXXXXXXXXXXXXX---g---------g--k-------y-XXXXXXXXXXXXXXXXXXXXXXXXXXXXXXXXXXX
SXXXXXXXXXXXXXXXXXXXXXXXXXXXXXXXXXXXXXXXXXXXXXXXXXXXXXXXXXXXXXXXXXXXXXXXXXXXXXXXXXXXXXXXXXXXXXXXXXXXXXXXXXXXXXXXXXXXXXXXXXXXXXXXXXXXXXXXXXXXXXXXXXXXXX
