S----SSSSSSSSSSSSSSSSSSSSSSSSSSSSSSSSSSSSSSSSSSSSSSSSSSSSSSSSSSSSSSSSSSSSSSSSSSSSSSSSSSSSSSSSSSSSSSSSSSSSSSSSSSSSSSSSSSSSSSSSSSSSSSSSSSSSSSSSSSSSSSSSS
S----SSSSSSS-----SSSSSSSSSSSSSSSSSS-------------SSSSSSSSSSSSSSSSSSS--------SSSSS-----------SSSSSSSSSSSSS-------SSSSSSSSSSSSSSSSSSSSSSSSSSSSSSSSSSSSSSS
S----SSSSSSS-----------SSSSSSSSSSSS-------------SSSSSSSSSSSSSSSSSSS------------------------SSSSSSSSSSSSS--------------------SSSSSSSS-----SSSSSSSSSSSSS
S----------------------SSSSSSSSSSSS-------------SSSSS--------------------------------------SSSSSS----------------------------------------SSSSSSSSSSSS-
S-----------------------------------------------------------------------------------------------------------------------------------------------------
S-----------------------------------------------------------------------------------------------------------------------------------------------------
S-----------------------------------------------------------------------------------------------------------------------------------------------------
S-----------------------------------------------------------------------------------------------------------------------------------------------------
S--------------------------oSSoSo---------------------------------------------------------------------------------------------------------------------
S--------------------------------------------------------------------------------SoSS---------------SSoSoooo------------------------------------------
S---------------------------ooooo--------------------------------------------------------------------------------oSoS---------------------------------
S-------------------r------------g-----------ooSoooo------------------k----------ooooo--------------ooooo--------------------------ooo----------------
SXXXXXXXXXXX-----XXXXXX---XXXXXXXXX---------------------oo---------XXXXXX--XXX----------------------------y---oooooooo-------------------------XXXXXXX
SXXXXXXXXXXXXXXXXXXXXXX---XXXXXXXXX----------oooo------------------XXXXXX--XXXXXXXXXXXXXXX--------XXXXXXXXXXX-------y--------------ooo------XXXXXXXXXX
SXXXXXXXXXXXXXXXXXXXXXX---XXXXXXXXXXXX---g----yg-----XXXXXX-----XXXXXXXXX--XXXXXXXXXXXXXXXXXXX----XXXXXXXXXXXXXXXXXXXXXX---g---XXX----------XXXXXXXXXX
SXXXXXXXXXXXXXXXXXXXXXXXXXXXXXXXXXXXXXXXXXXXXXXXXXXXXXXXXXXXXXXXXXXXXXXXXXXXXXXXXXXXXXXXXXXXXXXXXXXXXXXXXXXXXXXXXXXXXXXXXXXXXXXXXXXXXXXXXXXXXXXXXXXXXX
