S----SSSSSSSSSSSSSSSSSSSSSSSSSSSSSSSSSSSSSSSSSSSSSSSSSSSSSSSSSSSSSSSSSSSSSSSSSSSSSSSSSSSSSSSSSSSSSSSSSSSSSSSSSSSSSSSSSSSSSSSSSSSSSSSSSSSSSSSSSSSSSSSSS
S---------SSSSSSSSSSS-------------SSSSSSSSSSSSSSSSSSSSSSSSSSSSSSSSSSSSSSSSSSSSSSS--------SSSSSSSSSSSSSSSSSSSSSSSSSSSSSS------SSSSSSSSSSSSS--------SSSS
S---------------SSSSS-------------SSSSSSSSSSS-----------------------SSSSSSSSSSSSS--------SSSSSSS--------SSSSSSSS---------------------SSSSS--------SSSS
S---------------------------------SSSSSSSSSSS-----------------------------SSSSSSS--------SSSSSSS--------------------------------------------------SSSS
S-----------------------------------------------------------------------------------------------------------------------------------------------------
S-----------------------------------------------------------------------------------------------------------------------------------------------------
S-----------------------------------------------------------------------------------------------------------------------------------------------------
S-----------------------------------------------------------------------------------------------------------------------------------------------------
S-------------------------------------------------------------oooS---------------------Soo------------------ooSSoo------------------------------------
S----------ooooooo-------------------------------SSooo--------------------------------------------------------------------SoSS------------------------
S-----------------------------------ooo-----------------------ooooo----------------------------------------ooooo--------------------------------------
S------------------------------------------------oooo---------k-------------oSooo----------------ooooo----------g---------ooo------------ooo-----k----
S------------------XXXX------XXXXXX-oooo--------------------XXXXXXXX-----------------XXXXXXX-------------XXXXXXXXXX------r-------XXXXX-------XXXXXX---
S---------XXXXXXXXXXXXX-oooo-XXXXXX----------XXXXXXXXXXXXXXXXXXXXXXX-----oooooooo-XXXXXXXXXXXXXXXXXXXXXXXXXXXXXXXXX-----XXXXXXXXXXXXXXXXXXXXXXXXXXXXXX
SXXXXXXXXXXXXXXXXXXXXXX------XXXXXXXXXXXXXXXXXXXXXXXXXXXXXXXXXXXXXXXXXXX----y-----XXXXXXXXXXXXXXXXXXXXXXXXXXXXXXXXX-----XXXXXXXXXXXXXXXXXXXXXXXXXXXXXX
SXXXXXXXXXXXXXXXXXXXXXXXXXXXXXXXXXXXXXXXXXXXXXXXXXXXXXXXXXXXXXXXXXXXXXXXXXXXXXXXXXXXXXXXXXXXXXXXXXXXXXXXXXXXXXXXXXXXXXXXXXXXXXXXXXXXXXXXXXXXXXXXXXXXXX
