S----SSSSSSSSSSSSSSSSSSSSSSSSSSSSSSSSSSSSSSSSSSSSSSSSSSSSSSSSSSSSSSSSSSSSSSSSSSSSSSSSSSSSSSSSSSSSSSSSSSSSSSSSSSSSSSSSSSSSSSSSSSSSSSSSSSSSSSSSSSSSSSSSS
S----SSSSSSSSSSSSSSSSSSSSSSS-------------SSSSSSSSSSSSS----------------SSSSSSSSSSSSS-----SSSSSSSSSSSSSSSSSSSSSSSSSSSSSSSSSS------SSSSSSSSSSSSSSSSSSSSSS
S----SSSSSSSSSSSSSSS---------------------SSSSSSSS-----------------------------SSSSS-----SSSSSSSSSSSSSSSSSSSSSSSSSSSSSSSSSS--------------SSSSSSSSSSSSSS
S-----------------------------------------------------------------------------SSSSS-------------SSSSSSSS--------------------------------SSSSSSSSSSS---
S-----------------------------------------------------------------------------------------------------------------------------------------------------
S-----------------------------------------------------------------------------------------------------------------------------------------------------
S-----------------------------------------------------------------------------------------------------------------------------------------------------
S-----------------------------------------------------------------------------------------------------------------------------------------------------
S--------------------Soooooo--oSSSSo-----------------------------oSSooo------------oooSo--oooo--------------------------------------------------------
S-----------------------------------------------------------------------------------------------------------------------------------------------------
S----------------------oooo---oooo-------------------------------ooooooo-----------ooooo--------------------oSSoo-------------------------------------
S------------ooo------------------------------ooS-----------------------------------------------------------------------------------------------------
S----------------y-XXXXXXXXXXXXXXXXXX----oo---------------------XXXXXXXXXX--------XXXXXXXXXXXXXXXXXXXXXXXXX-ooooooo--XXXXXXXXXX--r--------------------
S-----------XXXXXXXXXXXXXXXXXXXXXXXXX---------oooo--------XXXXXXXXXXXXXXXX--------XXXXXXXXXXXXXXXXXXXXXXXXX--r----r--XXXXXXXXXXXXXXXXXXX--------------
S---------XXXXXXXXXXXXXXXXXXXXXXXXXXXXXXXXXXX-k--g-R------XXXXXXXXXXXXXXXXXXXXXXXXXXXXXXXXXXXXXXXXXXXXXXXXXXXXXXXXXXXXXXXXXXXXXXXXXXXXXXXXX----XXXXXXX
SXXXXXXXXXXXXXXXXXXXXXXXXXXXXXXXXXXXXXXXXXXXXXXXXXXXXXXXXXXXXXXXXXXXXXXXXXXXXXXXXXXXXXXXXXXXXXXXXXXXXXXXXXXXXXXXXXXXXXXXXXXXXXXXXXXXXXXXXXXXXXXXXXXXXX
