S----SSSSSSSSSSSSSSSSSSSSSSSSSSSSSSSSSSSSSSSSSSSSSSSSSSSSSSSSSSSSSSSSSSSSSSSSSSSSSSSSSSSSSSSSSSSSSSSSSSSSSSSSSSSSSSSSSSSSSSSSSSSSSSSSSSSSSSSSSSSSSSSSS
S------------SSSSS------------SSSSSSSSSSSSSSSSSSSS------SSSSS----------------SSSSSSSSSSSSSSSSSSSSSSSSSSSSSSSSSSSSS-------SSSSSSS-----SSSSSS------SSSSS
S------------SSSSS------------SSSSS-------SSSSSSSS------SSSSS----------------SSSSSS-------SSSSSSSSSSSSSSSSSSSSSSSS-------------------SSSSSS-----------
S----------------------------------------------------------------------------SSSSSS-------SSSSSS-------SSSSS-------------------------SSSSSS-----------
S-----------------------------------------------------------------------------------------------------------------------------------------------------
S-----------------------------------------------------------------------------------------------------------------------------------------------------
S-----------------------------------------------------------------------------------------------------------------------------------------------------
S-----------------------------------------------------------------------------------------------------------------------------------------------------
S---------------------ooS-----------------------ooooS-------------ooSSooooo---------------------------------------------------oooooS------------------
S--------------------------------------------------------------------------------------ooo--------------SoS-------------------------------------------
S---------------oSS-----oo-----------------------oooooo-----------ooooooooo--------------------ooo-----------------------------oooooo-----------------
S----------------------------Soo----------------------------------------k-----------ooooo----g----y-----oooooo-----------------k----------------------
S---------------oooo-XXXXXX-------oooo-XXXXXXXXXXXXXXXXX---------XXXXXXXXXXX-----XX---------XXXXXXXX-y--r--------------------XXXXXXXXXXX--------------
S---------------g-ky-XXXXXX--oo--------XXXXXXXXXXXXXXXXX---------XXXXXXXXXXX-----XXXXXXXXXXXXXXXXXXXXXXXXXXXXXX----XXXX--ooo-XXXXXXXXXXX--------------
S-------------XXXXXXXXXXXXX---y--XXXXXXXXXXXXXXXXXXXXXXX-----XXXXXXXXXXXXXXXXXXXXXXXXXXXXXXXXXXXXXXXXXXXXXXXXXXXXXXXXXX------XXXXXXXXXXXXXXXXXXXXXXX--
SXXXXXXXXXXXXXXXXXXXXXXXXXXXXXXXXXXXXXXXXXXXXXXXXXXXXXXXXXXXXXXXXXXXXXXXXXXXXXXXXXXXXXXXXXXXXXXXXXXXXXXXXXXXXXXXXXXXXXXXXXXXXXXXXXXXXXXXXXXXXXXXXXXXXX
