S----SSSSSSSSSSSSSSSSSSSSSSSSSSSSSSSSSSSSSSSSSSSSSSSSSSSSSSSSSSSSSSSSSSSSSSSSSSSSSSSSSSSSSSSSSSSSSSSSSSSSSSSSSSSSSSSSSSSSSSSSSSSSSSSSSSSSSSSSSSSSSSSSS
S----SSSSSSSSSSSSSSSSSSSS-----------SSSSSSS------------SSSSSSSSSS------SSSSSSSSSSSSSSSSSSSSSSSSSSSSSSSS-----SSSSSSSSSSSSSSSSSSSSSSS--------------SSSSS
S----SSSSSSS--------SSSSS-----------SSSSSSS-------------------------------------------SSSSS-----------------SSSSSSSSSSSSSSSSSSSSSSS--------------SSSSS
S----SSSSSSS--------------------------------------------------------------------------------------------------------SSSSSSSS---------------------SSSSS
S-----------------------------------------------------------------------------------------------------------------------------------------------------
S-----------------------------------------------------------------------------------------------------------------------------------------------------
S-----------------------------------------------------------------------------------------------------------------------------------------------------
S-----------------------------------------------------------------------------------------------------------------------------------------------------
S-----------------------------------------------------------------------------------------------------------------------------------------------------
S----------------------------------------------------------------SoSoSo----Soooo--------------------------------ooSSSSoS------------------------------
S----------------ooo----------------------------------------------------------------------------------------------------------------------------------
S--------------------r----SooSS-----SooooSo------------oSoSo-------------ooooooo---------------------------------oooooo------------oSo----------------
S-------------XXXXXXXXX----------------------oooooo-----------------------------------------XXX-oooooooo-XX------------g------------------------------
S---------XXXXXXXXXXXXX--ooooooo------oo-------y--k--ooooooo---XXXXXXXXXXXXXXXXXXXXXXXX-----XXX------k---XX----XXXXXXXXXXX-------oooooo-XXXXX-oooo----
SXXXXXXXXXXXXXXXXXXXXXX--------g---k--------XXXXXXXX-----------XXXXXXXXXXXXXXXXXXXXXXXXXXXXXXXXXXXXXXXXXXXXXXXXXXXXXXXXXXXXXXXXX--------XXXXX---yy----
SXXXXXXXXXXXXXXXXXXXXXXXXXXXXXXXXXXXXXXXXXXXXXXXXXXXXXXXXXXXXXXXXXXXXXXXXXXXXXXXXXXXXXXXXXXXXXXXXXXXXXXXXXXXXXXXXXXXXXXXXXXXXXXXXXXXXXXXXXXXXXXXXXXXXX
