S----SSSSSSSSSSSSSSSSSSSSSSSSSSSSSSSSSSSSSSSSSSSSSSSSSSSSSSSSSSSSSSSSSSSSSSSSSSSSSSSSSSSSSSSSSSSSSSSSSSSSSSSSSSSSSSSSSSSSSSSSSSSSSSSSSSSSSSSSSSSSSSSSS
S----SSSSSSSSSSSSSSSSSSSS---------------SSSSSSSSSSSSSSSSSSSSSSSSSSSSSSSSS-----------SSSSSSSSSSSSSSSSSSSSSSSSSSSSSSSSS----------SSSSSSSSSSSSSSSSSSSSSSS
S----SSSSSSSSSSSSSSSSSSSS---------------SSSSSSSSSSSS-------------SSSSSSSS-----------SSSSS-----SSSSSSSSSSSSSSSSSSSSSSS----------SSSSSSSSSSSSSSSSSSSSSSS
S---------------------------------------SSSSS--------------------SSSSSSSS---------------------SSSSSSSSSSSSSSSSSSSSSSS----------SSSSSSSSSSSSSSSS-------
S-----------------------------------------------------------------------------------------------------------------------------------------------------
S-----------------------------------------------------------------------------------------------------------------------------------------------------
S-----------------------------------------------------------------------------------------------------------------------------------------------------
S-----------------------------------------------------------------------------------------------------------------------------------------------------
S-------------------------oSSooooo--------------------------------oSSoSo---------------------------------------------------------ooSoS--------ooo-----
S-----------------------------------------------------oooSo----------------Soo---oSSSSo-------------ooo---oooooS--------SoSoo-------------------------
S-------------------------ooooooo--------------------------------------------------------------------------------------------------ooo-----ooooooooo--
S---------------SSoSSSoo---k--------ooSSoooo------------ooo---------k-------------oooooo-------------------oooooooo--oooooooo---------------gr-----k--
S------------------------XXXXXXXXXX-------------ooo--------------XXXXXXXX-----k-----r--------g-------g---------------g---------XXXXXXXXXXXXXXXXXXXXXX-
S--------------ooooooooo-XXXXXXXXXX----ooo--------k-XXXXXXXXXXX--XXXXXXXXXXXXXXXXXXXXXXXXXXXXXXXXXXXXXXXXXXXXXXXXXXXXXXXXXXXXXXXXXXXXXXXXXXXXXXXXXXXX-
SXXXXXXXXXXXXX----g------XXXXXXXXXX---k------XXXXXXXXXXXXXXXXXX--XXXXXXXXXXXXXXXXXXXXXXXXXXXXXXXXXXXXXXXXXXXXXXXXXXXXXXXXXXXXXXXXXXXXXXXXXXXXXXXXXXXXX
SXXXXXXXXXXXXXXXXXXXXXXXXXXXXXXXXXXXXXXXXXXXXXXXXXXXXXXXXXXXXXXXXXXXXXXXXXXXXXXXXXXXXXXXXXXXXXXXXXXXXXXXXXXXXXXXXXXXXXXXXXXXXXXXXXXXXXXXXXXXXXXXXXXXXX
