S----SSSSSSSSSSSSSSSSSSSSSSSSSSSSSSSSSSSSSSSSSSSSSSSSSSSSSSSSSSSSSSSSSSSSSSSSSSSSSSSSSSSSSSSSSSSSSSSSSSSSSSSSSSSSSSSSSSSSSSSSSSSSSSSSSSSSSSSSSSSSSSSSS
S----SSSSSSS-----SSSSSSSSSSSSSSSS-----SSSSSSSSSSSSS-------SSSSSSSSSSSSSSSSSSSSSSSSSSSSSSSSSSSSSSSSSSSS------SSSSSSSSSSSSSSSSSSSSSSSSSSSSSSSSSSSSSSSSSS
S----SSSSSSS-----SSSSSSSSSS-----------SSSSSSSSSSSSS-------SSSSS--------SSSSSSSSSSS-------SSSSS-------------------------SSSSSSSSSSSSSSSSSS-------SSSSSS
S----SSSSSSS--------------------------SSSSSSS-------------SSSSS--------SSSSSS------------------------------------------------------SSSSSS-------------
S-----------------------------------------------------------------------------------------------------------------------------------------------------
S-----------------------------------------------------------------------------------------------------------------------------------------------------
S-----------------------------------------------------------------------------------------------------------------------------------------------------
S-----------------------------------------------------------------------------------------------------------------------------------------------------
S-------------------------------------------------------------------------------------SoSoo-----------------------------------------------------------
S-----------------------------------------------------------------oooSSS----------------------------------------------oSoo----------------------------
S---------------oooSoSo----------------------------------------------------------------ooo-----------------------------------------------oooo---------
S---------------------------------------------------g-------------ooooooo--------------------------Soooo--------------oooooo------y-------------------
S----------------ooooooo-----oooo----XXXXXXXXX---XXXXXX-------------k---y-------XXXXXXXXXXXX----------------------------------XXXXXXXXX---ooooo-------
S-------------------------------y----XXXXXXXXXXXXXXXXXXXXXXXXXXXXXXXXXXXXXXXXX--XXXXXXXXXXXX------ooooo------------XXXXXXXXXXXXXXXXXXXX---------------
S--------------XXXXXXXXXXXXXXXXXXX---XXXXXXXXXXXXXXXXXXXXXXXXXXXXXXXXXXXXXXXXX--XXXXXXXXXXXXXXX-----r-----XXXX-----XXXXXXXXXXXXXXXXXXXXXXXXXXXXXX-----
SXXXXXXXXXXXXXXXXXXXXXXXXXXXXXXXXXXXXXXXXXXXXXXXXXXXXXXXXXXXXXXXXXXXXXXXXXXXXXXXXXXXXXXXXXXXXXXXXXXXXXXXXXXXXXXXXXXXXXXXXXXXXXXXXXXXXXXXXXXXXXXXXXXXXX
