S----SSSSSSSSSSSSSSSSSSSSSSSSSSSSSSSSSSSSSSSSSSSSSSSSSSSSSSSSSSSSSSSSSSSSSSSSSSSSSSSSSSSSSSSSSSSSSSSSSSSSSSSSSSSSSSSSSSSSSSSSSSSSSSSSSSSSSSSSSSSSSSSSS
S----SSSSSSSSSSSSSSSSSSSSSSSSSSSSSSSSSSSSSSSSSSSSSS------------SSSSSSSS------SSSSSSS--------SSSSSSSSSSSSSSSSSSSSSSSSSSS-----SSSSSSSSSSSSS-------------
S----SSSSSSSSSSSSSSSSSSSSSSSSSSS--------SSSSS-----------------------------------------------------SSSSSSSSSSSSSSSSSSSSS-----SSSSSSSSSSSSS-------------
S----SSSSSSSSSSSSS-------SSSSSSS--------SSSSS-----------------------------------------------------SSSSSSSSSSSSSSSSSSSSS-------------------------------
S-----------------------------------------------------------------------------------------------------------------------------------------------------
S-----------------------------------------------------------------------------------------------------------------------------------------------------
S-----------------------------------------------------------------------------------------------------------------------------------------------------
S-----------------------------------------------------------------------------------------------------------------------------------------------------
S-----------------------------------------------------------------------------------------------------------------------Sooooo------------------------
S------------------------------------------------------------ooo-----------SSS------------------------------------------------------------------------
S-------------------------------------SooS---------------------------------------------ooSSSo---------------oSoSSSoS----oooooo---------------Soo------
S-------------oSoSSSo---------------------------ooSS-------oooooooo--------ooooo------------------SSo-------------------------------------------------
SXXXXXXXXXX----------------------------ooooo----------------yk----------------k-----ooooooooo----------XXXX--oooooooo-XXXXXXXXX--------------oooo---XX
SXXXXXXXXXX----ooo------------------------------ooo-------XXXXXXXXXXXXXXXXXXXXXXX------g---K---oooo----XXXX----r-g----XXXXXXXXX---XXXXX---------r---XX
SXXXXXXXXXX-----------XXXXXXXX------XXXXXXXXX--y----------XXXXXXXXXXXXXXXXXXXXXXXXXXXXXXXXXXXX---------XXXXXXXXXXXXXXXXXXXXXXXXXXXXXXXX---XXXXXXXXXXXX
SXXXXXXXXXXXXXXXXXXXXXXXXXXXXXXXXXXXXXXXXXXXXXXXXXXXXXXXXXXXXXXXXXXXXXXXXXXXXXXXXXXXXXXXXXXXXXXXXXXXXXXXXXXXXXXXXXXXXXXXXXXXXXXXXXXXXXXXXXXXXXXXXXXXXX
