S----SSSSSSSSSSSSSSSSSSSSSSSSSSSSSSSSSSSSSSSSSSSSSSSSSSSSSSSSSSSSSSSSSSSSSSSSSSSSSSSSSSSSSSSSSSSSSSSSSSSSSSSSSSSSSSSSSSSSSSSSSSSSSSSSSSSSSSSSSSSSSSSSS
S----SSSSSSSSSSSSSSSSSSSSSS--------SSSSSSS-----------SSSSSSSSSS--------------------SSSSS-------------------SSSSSSSSSSSSSSSSSSSSSS-------SSSSSSS-------
S----SSSSS------SSSSSSSSSSS--------SSSSSSS-----------SSSSSSSSSS--------------------SSSSS---------------------------------SSSSSSSS-------SSSSSSS-------
S----SSSSS------------------------------------------------SSSSS----------------------------------------------------------SSSSSSSS-------SSSSSSS-------
S-----------------------------------------------------------------------------------------------------------------------------------------------------
S-----------------------------------------------------------------------------------------------------------------------------------------------------
S-----------------------------------------------------------------------------------------------------------------------------------------------------
S-----------------------------------------------------------------------------------------------------------------------------------------------------
S-----------------------------------------------------------------------------------------------------------ooSoSo-------------ooo--------------------
S--------------------------------------------ooooo---oooooSo--------------------------------oSo-------------------------------------------------------
S-----------------------------ooo-------------------------------------oo-------------------------ooooooSS---------------------------------------------
S-----------------------------------------------oo------ooo-------------------------------ooooo--------------k--k---------------k--R----------oo------
S--------------------------XXXXXXXXX--XXXXXX-k-----------------------XXXXXX------------------------oooo----XXXXXXXXXXXXXX----XXXXXXXXX--XXX-----------
SXXXXXXXXXXX--------ooooo--XXXXXXXXX--XXXXXXXXXXXXXXXXXXXXXXX--------XXXXXX--------------XXXXXXX-r----g-r--XXXXXXXXXXXXXX----XXXXXXXXXXXXXXXXXXXX-----
SXXXXXXXXXXX---XXX----r----XXXXXXXXX--XXXXXXXXXXXXXXXXXXXXXXXXXXXXXXXXXXXXX--------------XXXXXXXXXXXXXXXXXXXXXXXXXXXXXXXXXXXXXXXXXXXXXXXXXXXXXXXX-----
SXXXXXXXXXXXXXXXXXXXXXXXXXXXXXXXXXXXXXXXXXXXXXXXXXXXXXXXXXXXXXXXXXXXXXXXXXXXXXXXXXXXXXXXXXXXXXXXXXXXXXXXXXXXXXXXXXXXXXXXXXXXXXXXXXXXXXXXXXXXXXXXXXXXXX
