S----SSSSSSSSSSSSSSSSSSSSSSSSSSSSSSSSSSSSSSSSSSSSSSSSSSSSSSSSSSSSSSSSSSSSSSSSSSSSSSSSSSSSSSSSSSSSSSSSSSSSSSSSSSSSSSSSSSSSSSSSSSSSSSSSSSSSSSSSSSSSSSSSS
S----SSSSSSSSSSSSSSSS----------------SSSSSSSSSSSSSSSSSSSSSSSSSSSSSSSSSSSSSSSSSSSSSSSSSSSSSSSSSSSSSS------SSSSSSS----------------------SSSSSS------SSSS
S---------SSSSS----------------------------SSSSSSSSSSSSSSSSSSSSS---------------SSSSS-----SSSSSSSSSS------SSSSSSS----------------------SSSSSS------SSSS
S---------SSSSS----------------------------SSSSS--------SSSSSSSS---------------SSSSS-----SSSSS-----------SSSSSSS----------------------SSSSSS------SSSS
S-----------------------------------------------------------------------------------------------------------------------------------------------------
S-----------------------------------------------------------------------------------------------------------------------------------------------------
S-----------------------------------------------------------------------------------------------------------------------------------------------------
S-----------------------------------------------------------------------------------------------------------------------------------------------------
S------------oooSS---------------------------------------------------------------------------oSoo-----------------------------oooooo------------------
S-----------------------------------------------------------------------------------------------------------------ooSSS-------------------------------
S--------------oooo-----------------------------------------------oSooooSoo-----------------ooooo-----------------------------ooooo-------------------
S---------------------------------------------------oSoSo--------------------------------------Y-----oSSooo---------ooo-------------------------------
SXXXXXXXXXXXXXXXXXXXX--------ooooo--------------------------------oooooo-----------------k-XXXXXXX----------XXXXX--------XXXXXXXXXXXXX------XXX-------
SXXXXXXXXXXXXXXXXXXXX--------g-----XXXXX-----------ooooo--------------------XX--XXXXXXXXXXXXXXXXXX--ooooo---XXXXXXXXXXXXXXXXXXXXXXXXXX------XXX-------
SXXXXXXXXXXXXXXXXXXXX-----y-XXXXXXXXXXXX------y----------k-----XXXXXXXXXXXXXXXXXXXXXXXXXXXXXXXXXXX-----k--g-XXXXXXXXXXXXXXXXXXXXXXXXXXXX--XXXXX-------
SXXXXXXXXXXXXXXXXXXXXXXXXXXXXXXXXXXXXXXXXXXXXXXXXXXXXXXXXXXXXXXXXXXXXXXXXXXXXXXXXXXXXXXXXXXXXXXXXXXXXXXXXXXXXXXXXXXXXXXXXXXXXXXXXXXXXXXX--XXXXXXXXXXXX
