S----SSSSSSSSSSSSSSSSSSSSSSSSSSSSSSSSSSSSSSSSSSSSSSSSSSSSSSSSSSSSSSSSSSSSSSSSSSSSSSSSSSSSSSSSSSSSSSSSSSSSSSSSSSSSSSSSSSSSSSSSSSSSSSSSSSSSSSSSSSSSSSSSS
S----SSSSSSSSSSS------SSSSSSSSSSSSSSSS-----SSSSSSSS-------------------------SSSSSSSSSSSS-----SSSSSS-------SSSSSS-----SSSSSSSSSSSS-------SSSSSSSSSSSSSS
S----------SSSSS------SSSSSSSSSSSSSSSS--------------------------------------SSSSSSSSSSSS-----SSSSSS--------------------------------------------------S
S----------SSSSS------SSSSSS------------------------------------------------SSSSSSSSSSSS--------------------------------------------------------------
S-----------------------------------------------------------------------------------------------------------------------------------------------------
S-----------------------------------------------------------------------------------------------------------------------------------------------------
S-----------------------------------------------------------------------------------------------------------------------------------------------------
S-----------------------------------------------------------------------------------------------------------------------------------------------------
S-----------------------------------------------------------------------------------------------------------------------------------------------------
S--------------------------------------------------------------ooooS-----oSo--------------SSoo----------------------oSoSoSoo--------------------------
S----------------------------------------------------------------------------------------------------------------------------------------------ooSSSo-
S-------------------------------------Sooo------------------------oooo-----ooo-----------oooooo---------------------ooooooo----ooooooo----------------
S--------------------------------XXX----------XXX----------------k---------------r-------r----------XXXXXX----XXXXX---g-----g------G----XXXXXX--ooooo-
SXXXXXXXXXXX-oooo---------ooooo--XXX--ooooo---XXX--------oo---XXXXXXXXXXXXXXXXXXXXXXXXXXXXXXXXXXXXXXXXXXXXXXXXXXXXXXXXXXXXXXXXXXXXXXXXXXXXXXXX-----y--
SXXXXXXXXXXX-------XXXX-g--------XXX----------XXXXXXXXXX---r--XXXXXXXXXXXXXXXXXXXXXXXXXXXXXXXXXXXXXXXXXXXXXXXXXXXXXXXXXXXXXXXXXXXXXXXXXXXXXXXXXXXXXXXX
SXXXXXXXXXXXXXXXXXXXXXXXXXXXXXXXXXXXXXXXXXXXXXXXXXXXXXXXXXXXXXXXXXXXXXXXXXXXXXXXXXXXXXXXXXXXXXXXXXXXXXXXXXXXXXXXXXXXXXXXXXXXXXXXXXXXXXXXXXXXXXXXXXXXXX
