S----SSSSSSSSSSSSSSSSSSSSSSSSSSSSSSSSSSSSSSSSSSSSSSSSSSSSSSSSSSSSSSSSSSSSSSSSSSSSSSSSSSSSSSSSSSSSSSSSSSSSSSSSSSSSSSSSSSSSSSSSSSSSSSSSSSSSSSSSSSSSSSSSS
S----SSSSSSSSSSSSSSSSSSSSSSSSSSSSSSSSSSSSSSSSSSSSSSS------SSSSSSSSSSSSSSSSSSSSSSSSSSSSSS--------SSSSSSSSSSSSSSSSSSSSSSSSSSSSSSSSSSSSSSSSS-----SSSSSSSS
S----SSSSSSSSSSSS--------SSSSSSS--------SSSSSSSSSSSS--------------SSSSSSSSSSSSSSSSSSSSSS--------------SSSSSSSSSS-----SSSSSSSSSSSSSSSSSSSS------------S
S------------------------SSSSSSS---------------SSSSS----------------------------SSSSSSSS-------------------------------------SSSSSSS-----------------S
S-----------------------------------------------------------------------------------------------------------------------------------------------------
S-----------------------------------------------------------------------------------------------------------------------------------------------------
S-----------------------------------------------------------------------------------------------------------------------------------------------------
S-----------------------------------------------------------------------------------------------------------------------------------------------------
S---------------------------------oSoo--------------------------oSSoo----------------------------ooS--------------------------------------------------
S-----------------------------------------------------------------------------------------------------------------------------------------------------
S---------------------------------oooo-------oSo----------------ooooo-------SooSS------------------------------------------oo-------------------------
S------------------------ooooo----------------------oooSoS------------------------------ooo---------y----------------------------ooSo-----------oooo--
S-----------XXXX---y------r-----XXXXXXXXXX--oo--------------XXXXXXXXXXX-----ooooo---------------XXXXXXX-------XXXXX------XXXXXX----------------y------
S-----------XXXX--XXXXXXXXXXXXXXXXXXXXXXXX----------ooooooo-XXXXXXXXXXX------r--k-------ooooo-XXXXXXXXX-------XXXXXXXXXXXXXXXXX-------------XXXXXXXXXX
S-----------XXXX--XXXXXXXXXXXXXXXXXXXXXXXXXXXXXXX--------rg-XXXXXXXXXXXXXXXXXXXXXXXX----------XXXXXXXXXXXXX---XXXXXXXXXXXXXXXXX--------XXXXXXXXXXXXXXX
SXXXXXXXXXXXXXXXXXXXXXXXXXXXXXXXXXXXXXXXXXXXXXXXXXXXXXXXXXXXXXXXXXXXXXXXXXXXXXXXXXXXXXXXXXXXXXXXXXXXXXXXXXXXXXXXXXXXXXXXXXXXXXXXXXXXXXXXXXXXXXXXXXXXXX
