S----SSSSSSSSSSSSSSSSSSSSSSSSSSSSSSSSSSSSSSSSSSSSSSSSSSSSSSSSSSSSSSSSSSSSSSSSSSSSSSSSSSSSSSSSSSSSSSSSSSSSSSSSSSSSSSSSSSSSSSSSSSSSSSSSSSSSSSSSSSSSSSSSS
S----SSSSSSSSSSSS-----SSSSSSSSSSSSSSSSSSSSSSSSSSSSSSSSSSSSSSSSSSSSSSSSSSSSSSSSSSSSS------SSSSSSSSSSSSSSSSSSSSSS-----SSSSSSSSSSSSSSSSSS--------SSSSSSSS
S----SSSSSSS----------SSSSSSSSSSSSSSSSSSSSSSSSSS-------SSSSSSSSSSSSSSSSSSSSSSSSSSSS------SSSSS-------SSSSSSSSSS-----SSSSSSSSSSSSSSSSSS--------SSSSSSSS
S----SSSSSSS---------------------------------------------------------SSSSSSSSSSSSSS------SSSSS------------SSSSS-----SSSSS-------SSSSSS--------SSSSSSSS
S-----------------------------------------------------------------------------------------------------------------------------------------------------
S-----------------------------------------------------------------------------------------------------------------------------------------------------
S-----------------------------------------------------------------------------------------------------------------------------------------------------
S-----------------------------------------------------------------------------------------------------------------------------------------------------
S---------------------------------------------------SoSS------------------------------------ooo-----------oSooS---------------------------------------
S---------------------------------------oSoSooSo-----------------------------------------------------------------------------ooo----------------------
S------------ooooS----------------------------------oooo------------------------oooSoS----------------------------------------------------------------
S----------------------------oSoSSo-------oooo----K----r----------ooo----------------------------------------kg--------------ooo----------------------
SXXXXXXXXXXX-oooooo-----ooo------------k---------XXXXXXXXXX---------------------oooooooo---XXXXXXX----oo-XXXXXXXX-------------------------------------
SXXXXXXXXXXX--k--------r--------ooo---XXXXXXXXXXXXXXXXXXXXX--------oo--------------------XXXXXXXXX--G----XXXXXXXX-----------XXXXXXX-----XXXX----------
SXXXXXXXXXXXXXXXXXXXXXXXXXXX----------XXXXXXXXXXXXXXXXXXXXX-----gk--y---XXXXXXXXXXXXXXXXXXXXXXXXXXXXXXXXXXXXXXXXXXXXXXXXXXXXXXXXXXX-----XXXXXXXXXXXXXX
SXXXXXXXXXXXXXXXXXXXXXXXXXXXXXXXXXXXXXXXXXXXXXXXXXXXXXXXXXXXXXXXXXXXXXXXXXXXXXXXXXXXXXXXXXXXXXXXXXXXXXXXXXXXXXXXXXXXXXXXXXXXXXXXXXXXXXXXXXXXXXXXXXXXXX
