S----SSSSSSSSSSSSSSSSSSSSSSSSSSSSSSSSSSSSSSSSSSSSSSSSSSSSSSSSSSSSSSSSSSSSSSSSSSSSSSSSSSSSSSSSSSSSSSSSSSSSSSSSSSSSSSSSSSSSSSSSSSSSSSSSSSSSSSSSSSSSSSSSS
S----SSSSSSSSSSSSSSS------SSSSSSSSSSSSSSSSSSSS-----SSSSSSSSSS------SSSSSSSSSSSSSSS-----SSSSSS------SSSSS-------SSSSSSSSSSSS--------SSSSSSSSSSSSSSSSSSS
S-----------SSSSSSSS------------SSSSSS-------------SSSSSSSSSS--------------------------------------------------SSSSSSSSSSSS--------SSSSSSSSSSSSSSSSSSS
S-----------SSSSSSSS------------SSSSSS-------------SSSSS-------------------------------------------------------SSSSS----------------------------------
S-----------------------------------------------------------------------------------------------------------------------------------------------------
S-----------------------------------------------------------------------------------------------------------------------------------------------------
S-----------------------------------------------------------------------------------------------------------------------------------------------------
S-----------------------------------------------------------------------------------------------------------------------------------------------------
S------------------------------------oSS--------------------------------------------oSSoo-------------------------------------------------------------
S----------------------------------------------------------------------------------------------------------------oooSoo--oSSS-------------------------
S-------------SoooSo----------------------------------------------------------------oooo-------------------------------------------------oSo----------
S---------------------ooooo----------------------------ooSS--------------oooSoSooo-------r-------ooooo-----G-k---ooooo-----------ooo------------------
SXXXXXXXXXXX-ooooooo----------------XXXXXX-ooo---XXXXX-------XXXXXX----------------XXXXXXXX--------------XXXXXX--g----------------------ooooooo-------
SXXXXXXXXXXX----------ooooo-XXX-----XXXXXX-r-----XXXXX---oo--XXXXXXXXX-----ooooooo-XXXXXXXXXXXXX---oo----XXXXXXXXXXXXXXXXXXXXXXXXXXXXX------y---XXXXX-
SXXXXXXXXXXXXXXXXXXXX-------XXX-----XXXXXXXXXXXXXXXXXX-------XXXXXXXXX-------------XXXXXXXXXXXXX---g-----XXXXXXXXXXXXXXXXXXXXXXXXXXXXXXXXXXXXXXXXXXXX-
SXXXXXXXXXXXXXXXXXXXXXXXXXXXXXXXXXXXXXXXXXXXXXXXXXXXXXXXXXXXXXXXXXXXXXXXXXXXXXXXXXXXXXXXXXXXXXXXXXXXXXXXXXXXXXXXXXXXXXXXXXXXXXXXXXXXXXXXXXXXXXXXXXXXXX
