S----SSSSSSSSSSSSSSSSSSSSSSSSSSSSSSSSSSSSSSSSSSSSSSSSSSSSSSSSSSSSSSSSSSSSSSSSSSSSSSSSSSSSSSSSSSSSSSSSSSSSSSSSSSSSSSSSSSSSSSSSSSSSSSSSSSSSSSSSSSSSSSSSS
S----SSSSSSSSSSSSSSSSSSSSSSSSSSSSSSSSSSSSSSSSSSS--------SSSSSSSS-----SSSSSSSSSSSSSS-----SSSSSSS------SSSSSSSSSSSSSSSSSSSSSSSSSSSSSSSSSSSSSSSSSSSSSSSSS
S----SSSSSSSSSSSSSSS--------SSSSSSSSSSSSSSSSSSSS--------SSSSSSSS-----SSSSSSSS-----------SSSSSSS------SSSSSSS-------SSSSSSSSSSSSSSSSSSSSSSSSSSSSSSSSSSS
S----SSSSSSSSSSSSSSS---------------SSSSSSSSSSSSS--------SSSSSSSS-------------------------------------SSSSSSS-------------SSSSSSSS-------------SSSSSS--
S-----------------------------------------------------------------------------------------------------------------------------------------------------
S-----------------------------------------------------------------------------------------------------------------------------------------------------
S-----------------------------------------------------------------------------------------------------------------------------------------------------
S-----------------------------------------------------------------------------------------------------------------------------------------------------
S------------------------------------------------------------------------------oSSoSSooo--------------------------------------------------------------
S---------------------------------------------Sooo----------------------------------------------------------------------------------------------------
S-------------------------------ooSoo---------------------------------------------oooooo--oo----------------------------------ooS---------------------
S----------------SoS------------------------------------------Sooo----oooS--------y----------g--------------------------------------------------ooo---
S-------------------------XXXXX---oooo---------------XXXXXX-----------------XXXXXXXXXXXXXXXXXXXX-------XXXXXXX----------------ooooo----oo------k-g----
S---------XXXX---oooo---XXXXXXX--------XXXXXXXXXXXX--XXXXXX--oooo------oo---XXXXXXXXXXXXXXXXXXXX-------XXXXXXXXXXXX-------XX-----------r----XXXXXXXXXX
S---------XXXX----------XXXXXXXXXXXXXXXXXXXXXXXXXXXXXXXXXXX-----kr--y-------XXXXXXXXXXXXXXXXXXXXXXXXX--XXXXXXXXXXXX----XXXXXXXXXXXXXXXXXXXXXXXXXXXXXXX
SXXXXXXXXXXXXXXXXXXXXXXXXXXXXXXXXXXXXXXXXXXXXXXXXXXXXXXXXXXXXXXXXXXXXXXXXXXXXXXXXXXXXXXXXXXXXXXXXXXXXXXXXXXXXXXXXXXXXXXXXXXXXXXXXXXXXXXXXXXXXXXXXXXXXX
