S----SSSSSSSSSSSSSSSSSSSSSSSSSSSSSSSSSSSSSSSSSSSSSSSSSSSSSSSSSSSSSSSSSSSSSSSSSSSSSSSSSSSSSSSSSSSSSSSSSSSSSSSSSSSSSSSSSSSSSSSSSSSSSSSSSSSSSSSSSSSSSSSSS
S----SSSSSSSSSSSSSSSSSSSSSSSSSSSSSSSSSSSSSSSSSSSSSSSSSSSSSSSSSSSSSSSSSSSSSSSSSSS------SSSSSSSS-------------SSSSSSSSSSSSSSSSSSSSSSSSSSSSSSSSSSSSSSSSSSS
S----SSSSSSSSSSSSSSSSSSSSS------SSSSSSSSSSSSSSSSSSSSSSSSSSSSSSS-------SSSSS-----------SSSSSSSS-------------SSSSSSSSSSSSSSSSSSSSSSSSSSSSSSSSSSS--------
S----------SSSSSSSSSSSSSSS------SSSSSS------------SSSSSSSSSSSSS-------SSSSS--------------------------------------------SSSSSSSSSSSSSSS----------------
S-----------------------------------------------------------------------------------------------------------------------------------------------------
S-----------------------------------------------------------------------------------------------------------------------------------------------------
S-----------------------------------------------------------------------------------------------------------------------------------------------------
S-----------------------------------------------------------------------------------------------------------------------------------------------------
S-----------------------------------------------------oSo---------------------------------------------------------------------------------------------
S-----------------------------------ooS------------------------------------------------------ooSo-----------------------------------------------------
S-------------------------oooo---------------------ooo-----ooSS-----ooo------------------------------oSoSS------------Soo------ooo--------------------
S---------------SoSoooo-------------oo-------------------------------r-----ooS-----oooo--------ooo-----------ooS--------------------------------------
S-------------------------ooooo-----------XXXXXXXXXXXXXXXX--------XXXXXXX------------------------k----oo------------oooooo----------------------------
SXXXXXXXXXXXX----oooooo-----r----XXXXXXXXXXXXXXXXXXXXXXXXX--------XXXXXXX---oo------ooo-----XXXXXXXX---y-----oo-------r-y----------XXXXX--------XX----
SXXXXXXXXXXXX-----------XXXXXXXXXXXXXXXXXXXXXXXXXXXXXXXXXXXXXXXXXXXXXXXXX------------r----XXXXXXXXXXXXXXXXXX------XXXXXXXXXXXXXXXXXXXXXXXXXXXXXXXXXXXX
SXXXXXXXXXXXXXXXXXXXXXXXXXXXXXXXXXXXXXXXXXXXXXXXXXXXXXXXXXXXXXXXXXXXXXXXXXXXXXXXXXXXXXXXXXXXXXXXXXXXXXXXXXXXXXXXXXXXXXXXXXXXXXXXXXXXXXXXXXXXXXXXXXXXXX
