S----SSSSSSSSSSSSSSSSSSSSSSSSSSSSSSSSSSSSSSSSSSSSSSSSSSSSSSSSSSSSSSSSSSSSSSSSSSSSSSSSSSSSSSSSSSSSSSSSSSSSSSSSSSSSSSSSSSSSSSSSSSSSSSSSSSSSSSSSSSSSSSSSS
S----SSSSSSSSSSSSSSSSSSSSSSSSSSSSSSSSSSSSSSSSSSSSSSSSSSSSSSSSSSSSSSSSSSS-----SSSSSS-------------SSSSSSSSSSSSSSS------SSSSSSSSSSSSSSSSSSSSSSSSSSSSSSSSS
S----SSSSSSS------SSSSSSSSSSSSSSSSSSSSSSSSSSSSSSS---------------SSSSSSSS------------------------SSSSSSSSSSSSSSS------SSSSSSSSSSSSSSSSSSSSSS-------SSSS
S-------------------------SSSSSSSS------------------------------SSSSSSSS--------------------------------------------------SSSSSS-----SSSSSS-------SSSS
S-----------------------------------------------------------------------------------------------------------------------------------------------------
S-----------------------------------------------------------------------------------------------------------------------------------------------------
S-----------------------------------------------------------------------------------------------------------------------------------------------------
S-----------------------------------------------------------------------------------------------------------------------------------------------------
S-----------------------SSo----------oSooSo-----------SSo------------------------SSoSSo-----------------------------------------------------SSoo------
S--------------------------------------------------------------------ooooSSoo-------------------------ooSooSoSo---------------------------------------
S--------------------oooooo----------oooo------------ooooo---ooooo--------------oooo------------------------------------------------------ooooo-------
S----------------------g----------------k-----------------------g-------ooo------------------------------ooo-----------oooo--------------yy-----------
S-------------------XXXXXXXXX-----XXXXXXXXXX------XXXXXXXXXXXXXXXXXX-----------XXXXXXXXX--XXXX-----------r------XXXX----------oooooo-XXXXXXXXXXXXX----
S---------------oo--XXXXXXXXX---XXXXXXXXXXXX------XXXXXXXXXXXXXXXXXXXXXXXXXXXXXXXXXXXXXX--XXXX-------XXXXXXXXXXXXXXX--ooo------------XXXXXXXXXXXXX----
S-------------------XXXXXXXXX---XXXXXXXXXXXX--r---XXXXXXXXXXXXXXXXXXXXXXXXXXXXXXXXXXXXXX--XXXX-----XXXXXXXXXXXXXXXXX-----Y---XXXXXXXXXXXXXXXXXXXXXXXXX
SXXXXXXXXXXXXXXXXXXXXXXXXXXXXXXXXXXXXXXXXXXXXXXXXXXXXXXXXXXXXXXXXXXXXXXXXXXXXXXXXXXXXXXXXXXXXXXXXXXXXXXXXXXXXXXXXXXXXXXXXXXXXXXXXXXXXXXXXXXXXXXXXXXXXX
