S----SSSSSSSSSSSSSSSSSSSSSSSSSSSSSSSSSSSSSSSSSSSSSSSSSSSSSSSSSSSSSSSSSSSSSSSSSSSSSSSSSSSSSSSSSSSSSSSSSSSSSSSSSSSSSSSSSSSSSSSSSSSSSSSSSSSSSSSSSSSSSSSSS
S----SSSSSSSSSSSSSSSSSSSSSSS-------SSSSSSSSSSSSSSSSSSS------SSSSSSSSSSSSS------------SSSSSSSS--------SSSSSSS------SSSSSSSSSSSSSSSSSSSSSSSSSSSSSSSSSSSS
S----SSSSSSSSSSSSSSS----------------------------------------SSSSSSSSSSSSS------------SSSSSSSS---------------------SSSSSSSSSSSSSSSSSSSSSSS-------SSSSSS
S----SSSSSSSS-----------------------------------------------------SSSSSSS-------------------------------------------------SSSSSSSSSSSSSSS-------SSSSSS
S-----------------------------------------------------------------------------------------------------------------------------------------------------
S-----------------------------------------------------------------------------------------------------------------------------------------------------
S-----------------------------------------------------------------------------------------------------------------------------------------------------
S-----------------------------------------------------------------------------------------------------------------------------------------------------
S--------------------------------------------------------------------------------oSo--oSSooo----------------------------------------------------------
S--------------------------------------------------------------------------------------------------------------------ooSoSo---------------------------
S----------------------------------------------------oSooo---------------------oooo-------------------------------------------ooSSoooS------ooSS------
S-----------------------------------------------------------------------------------------------------------------------------------------------------
S------------------------XXX-----------*--------------oooo-----------oo-------XXXXXXXXXXXXXXX-----oooo-------ooooo----r----------oooooo--oooooo-------
S-------------ooo--------XXX----ooo----*-----------------yY---XXX-------------XXXXXXXXXXXXXXX-----------------------XXXXXXXXX-r-------y---------------
SXXXXXXXXXXXX---G---XXXXXXXXXXX------XXXXXX---------XXXXXXXXXXXXXXXXXXXXXXX---XXXXXXXXXXXXXXXXXXXXXXXXXXX--XXXXXXXXXXXXXXXXXXXXXXXXXXXXXXXXXXXXXXXXXXX
SXXXXXXXXXXXXXXXXXXXXXXXXXXXXXXXXXXXXXXXXXXXXXXXXXXXXXXXXXXXXXXXXXXXXXXXXXXXXXXXXXXXXXXXXXXXXXXXXXXXXXXXXXXXXXXXXXXXXXXXXXXXXXXXXXXXXXXXXXXXXXXXXXXXXX
