S----SSSSSSSSSSSSSSSSSSSSSSSSSSSSSSSSSSSSSSSSSSSSSSSSSSSSSSSSSSSSSSSSSSSSSSSSSSSSSSSSSSSSSSSSSSSSSSSSSSSSSSSSSSSSSSSSSSSSSSSSSSSSSSSSSSSSSSSSSSSSSSSSS
S----SSSSS------SSSSSSSSSSSSSSSSSSSSSSSSSSSSSSSSSSSSSSSSSSSSSSSSSSSSSSSSSSSSSSSSSSSSSSSSSSSSSSSS--------SSSSSSSSSSSSSSSSSSSS--------SSSSSSSSSSSSSSSSSS
S----SSSSS------SSSSSSSSSS------SSSSSSSSSSSS--------------SSSSSSSSSSSSS-------SSSSSSSSSS----------------SSSSSSSSSSSSSSSSSSSS--------SSSSSSS--------SSS
S----SSSSS------SSSSS--------------------------------------------SSSSSS-------SSSSSSSSSS-----------------------------SSSSSSS--------SSSSSSS-----------
S-----------------------------------------------------------------------------------------------------------------------------------------------------
S-----------------------------------------------------------------------------------------------------------------------------------------------------
S-----------------------------------------------------------------------------------------------------------------------------------------------------
S-----------------------------------------------------------------------------------------------------------------------------------------------------
S---------------------------------------------------------------------------oSo------------------ooo--------------------------------------------------
S-------------------------------------------------------------SoS-------------------------------------------------------------------------------------
S---------------------ooo------------------ooooo--------------------------------------------------ooo---------ooo---------------ooo-------------------
S------------------------------------------------------------oooo---ooSSo---y-k-r--oooSSSSSo----------------------------------------------------------
S------------ooooo--XXXXXXXXXXXXX----oo----oooooo-------------------------XXXXXXXX-------------XXXXXXX-------XXXXXX----------oooo------ooooo----------
SXXXXXXXXXXX--------XXXXXXXXXXXXX--k------------------XXX--XXXXXXXX-------XXXXXXXX----ooo------XXXXXXXXX-----XXXXXX-------------------------------oo--
SXXXXXXXXXXXXXXXXXXXXXXXXXXXXXXXXXXXXXXXXXXXXXXXXXXXXXXXXXXXXXXXXXX-------XXXXXXXX---K----y----XXXXXXXXX-----XXXXXX---------XXXXXXXXXXXXXXXXXX-----rg-
SXXXXXXXXXXXXXXXXXXXXXXXXXXXXXXXXXXXXXXXXXXXXXXXXXXXXXXXXXXXXXXXXXXXXXXXXXXXXXXXXXXXXXXXXXXXXXXXXXXXXXXXXXXXXXXXXXXXXXXXXXXXXXXXXXXXXXXXXXXXXXXXXXXXXX
