S----SSSSSSSSSSSSSSSSSSSSSSSSSSSSSSSSSSSSSSSSSSSSSSSSSSSSSSSSSSSSSSSSSSSSSSSSSSSSSSSSSSSSSSSSSSSSSSSSSSSSSSSSSSSSSSSSSSSSSSSSSSSSSSSSSSSSSSSSSSSSSSSSS
S----SSSSSSSSSSSSSS------SSSSSSSSSSSSSSSSSSSS-------SSSSSSSSSSSSSSSSSSSSSSSSSSSSSSSSSS-------------------SSSSSSSSSSSSSSSSSSSSSSSSS-------SSSSSSSS-----
S----SSSSSSSSSSSSSS------SSSSSSSSSSSSSSSSSSSS-------SSSSSSSSSSSSSSS------------SSSSSSS-------------------SSSSSSSSSS--------SSSSSSS-------SSSSSSSS-----
S------------------------SSSSSSSSSSSSSSSSSSSS------------------------------------------------------------SSSSSSSSSS--------SSSSSSS-------SSSSSSSS-----
S-----------------------------------------------------------------------------------------------------------------------------------------------------
S-----------------------------------------------------------------------------------------------------------------------------------------------------
S-----------------------------------------------------------------------------------------------------------------------------------------------------
S-----------------------------------------------------------------------------------------------------------------------------------------------------
S------------------------------------------------------------------------oooSo-----------------------------------------ooSoo--------------------------
S----------------------------------------------------------------------------------------oSoo--------------------Soo----------------------------------
S---------------ooo----------oo-----------------X--X---------oooooo-------ooo------------------------------------------ooooo--------------------------
S----------------------------------------------XX--XX------------------------------------oooo---------oooooooo---ooo------g---------------------------
S-----------------oo-XXXXXXXXXXXXXX-----------XXX--XXX-------oooooo----XXXXXXXXX------------------oo------------kg----XXXXXXX-----y-k--XXXXXXXXXXXXXXX
SXXXXXXXXXXXXX-------XXXXXXXXXXXXXXXXX------XXXXX--XXXXXXXXX---r-------XXXXXXXXX--------XXXXXXX---------oooo---XXXXXXXXXXXXXXXXXXXXXXXXXXXXXXXXXXXXXXX
SXXXXXXXXXXXXXXXXXXXXXXXXXXXXXXXXXXXXXXXXXXXXXXXX--XXXXXXXXXXXXXXXXXXXXXXXXXXXXX------XXXXXXXXXXXXXXX------k---XXXXXXXXXXXXXXXXXXXXXXXXXXXXXXXXXXXXXXX
SXXXXXXXXXXXXXXXXXXXXXXXXXXXXXXXXXXXXXXXXXXXXXXXX--XXXXXXXXXXXXXXXXXXXXXXXXXXXXXXXXXXXXXXXXXXXXXXXXXXXXXXXXXXXXXXXXXXXXXXXXXXXXXXXXXXXXXXXXXXXXXXXXXXX
