S----SSSSSSSSSSSSSSSSSSSSSSSSSSSSSSSSSSSSSSSSSSSSSSSSSSSSSSSSSSSSSSSSSSSSSSSSSSSSSSSSSSSSSSSSSSSSSSSSSSSSSSSSSSSSSSSSSSSSSSSSSSSSSSSSSSSSSSSSSSSSSSSSS
S----SSSSSSSSSSSSSSSSSSSSSSSSSS-------SSSSS-------SSSSSS-----------------SSSSSS-------SSSSSSSSSSSSSSSSSSSSSSSSSSSSSSSSSSSSSSSSSSS--------SSSSSSSSSSSSS
S-----------------SSSSSSSSSSSSS-------SSSSS-------SSSSSS-------------------------------------------------------SSSSSS----------------------------SSSSS
S-----------------SSSSSSSS-------------------------------------------------------------------------------------SSSSSS---------------------------------
S-----------------------------------------------------------------------------------------------------------------------------------------------------
S-----------------------------------------------------------------------------------------------------------------------------------------------------
S-----------------------------------------------------------------------------------------------------------------------------------------------------
S-----------------------------------------------------------------------------------------------------------------------------------------------------
S-----------------------------------------oooo-------SoSoo--------------ooS---------------------------------------------------------------------------
S-----------------------------------------------------------------------------------------------------------------------------------------------------
S----------------------------------------oooooo-----oooooooo-----------oooooo----------------------------oooSSoo------------oSoo----------------------
S-------------------oo------------------------g---------G---------------k--y-------------oSooo---------------------------------------SoooSSoo---------
SXXXXXXXXXXX---------------oooooo--XXXXXXXXXXXXXXXXXXXXXXXXXX----XXXXXXXXXXXXXX----g---------------k------ooooo-----------ooooooo---------------------
SXXXXXXXXXXXXXXXXXXXXXXXXX-------y-XXXXXXXXXXXXXXXXXXXXXXXXXX----XXXXXXXXXXXXXX---XXXXXX---ooo--XXXXXX-----------------XX-Gy---------oooooooo-XXXXX---
SXXXXXXXXXXXXXXXXXXXXXXXXXXXXXXXXXXXXXXXXXXXXXXXXXXXXXXXXXXXXXXXXXXXXXXXXXXXXXXXXXXXXXXX----y---XXXXXXXXXXXXXXXXXXXXXXXXXXXXXXXXXXX--k--------XXXXX--X
SXXXXXXXXXXXXXXXXXXXXXXXXXXXXXXXXXXXXXXXXXXXXXXXXXXXXXXXXXXXXXXXXXXXXXXXXXXXXXXXXXXXXXXXXXXXXXXXXXXXXXXXXXXXXXXXXXXXXXXXXXXXXXXXXXXXXXXXXXXXXXXXXXXXXX
