S----SSSSSSSSSSSSSSSSSSSSSSSSSSSSSSSSSSSSSSSSSSSSSSSSSSSSSSSSSSSSSSSSSSSSSSSSSSSSSSSSSSSSSSSSSSSSSSSSSSSSSSSSSSSSSSSSSSSSSSSSSSSSSSSSSSSSSSSSSSSSSSSSS
S----SSSSS------SSSSSS-----------SSSSSSSSSSSSSSSSSSS-------SSSSSSSSSSSSSSSSSSSSS-------SSSSSSSSSSSSSSSSSSSSSSS--------SSSSSSSSSSSSSSS-----SSSSSSSSSSSS
S---------------SSSSSS-----------SSSSSSSSSSSSS-------------SSSSSSS---------------------SSSSSSSSSSSSSSSSSSSSSSS---------------SSSSSSSS-----SSSSSSSSSSSS
S---------------SSSSSS-----------SSSSSSSSSSSSS-----------------------------------------SSSSSSSSSSSSSSSSSSSSSSS---------------SSSSSSSS-----SSSSSSS-----
S-----------------------------------------------------------------------------------------------------------------------------------------------------
S-----------------------------------------------------------------------------------------------------------------------------------------------------
S-----------------------------------------------------------------------------------------------------------------------------------------------------
S-----------------------------------------------------------------------------------------------------------------------------------------------------
S---------------------------------------------------oSooo-------ooooo---------------------------------------------------------------------------------
S--------------------------------------------oSoo------------------------------------oSo-----------------------------oooSoo----------------ooo--------
S-----------------------------------------------------oo--------oooooo--oSoSooSo----------------------------------------------------------------------
S----------------------oooooooo----SSoS--------------y----------g------------------oooooo---------------------------ooooooo------oooooo---oooooo------
S-------------------------------------------------XXXXXXXXXXXXXXXXXXXXX-ooooooo------------------ooooo----------------k-----XXX-----------g-------XXX-
S----------XXXXXXXXXX--ooooo-------ooo---XXXXXXXXXXXXXXXXXXXXXXXXXXXXXX----------XXXXXXXXXXX---------y------XXXXXXXXXXXXXXXXXXXXXXXXXXXXXXXXXXXXXXXXX-
SXXXXXXXXXXXXXXXXXXXX----rr--------------XXXXXXXXXXXXXXXXXXXXXXXXXXXXXXXXXXXXXXXXXXXXXXXXXXXXXXXXXXXXXX-----XXXXXXXXXXXXXXXXXXXXXXXXXXXXXXXXXXXXXXXXX-
SXXXXXXXXXXXXXXXXXXXXXXXXXXXXXXXXXXXXXXXXXXXXXXXXXXXXXXXXXXXXXXXXXXXXXXXXXXXXXXXXXXXXXXXXXXXXXXXXXXXXXXXXXXXXXXXXXXXXXXXXXXXXXXXXXXXXXXXXXXXXXXXXXXXXX
