S----SSSSSSSSSSSSSSSSSSSSSSSSSSSSSSSSSSSSSSSSSSSSSSSSSSSSSSSSSSSSSSSSSSSSSSSSSSSSSSSSSSSSSSSSSSSSSSSSSSSSSSSSSSSSSSSSSSSSSSSSSSSSSSSSSSSSSSSSSSSSSSSSS
S----SSSSSSSSSSSSSSSSSSSSSSSSSSSSSSSSSSSSSSSSSSSSSSSSS-----SSSSSSSSSSS------SSSSSSSSSSSSSSS--------------------------SSSSSSSSSSSSSSSSSSSSSSSSSSSSSSSSS
S----SSSSSSSSSSSSSSS-------------SSSSSSS--------SSSSSS-----SSSSSSSSSSS----------------------------------------------------------SSSSSSSSSSSSSSSSSSSSSS
S-----------------------------------------------SSSSSS-----SSSSSS---------------------------------------------------------------SSSSSS-------SSSSSSSS-
S-----------------------------------------------------------------------------------------------------------------------------------------------------
S-----------------------------------------------------------------------------------------------------------------------------------------------------
S-----------------------------------------------------------------------------------------------------------------------------------------------------
S-----------------------------------------------------------------------------------------------------------------------------------------------------
S-------------ooooSo------------------------------------------------------------------------------------------------------------SooS------------------
S------------------------ooS--------------------------------------------------------ooo---ooSSooS-----------------------ooS---------------------------
S-----------oooooo-----------------------------------------------------------------------------------oSSoo-----------------------oooo-----------------
S-----------------r------oo---------------------------------------------------------oooo---oooooo---------------r----------------g----------X---X-----
S----------XXXXXXXXXX----r--y-------------XXXXXX-------------------------------------Y------y--------oooooo---XXXXXXXXX-k-----XXXXXXXX----XXX---XXX---
SXXXXXXXXXXXXXXXXXXXXXXXXXXXXXXXXXX-------XXXXXX-------XXX---XXX-----------------XXXXXXXXXXXXXXXXXX-------r-k-XXXXXXXXXXXXXXXXXXXXXXXX----XXX---XXX---
SXXXXXXXXXXXXXXXXXXXXXXXXXXXXXXXXXXXX---XXXXXXXX-------XXX---XXXXXXX---XXXXXXXXXXXXXXXXXXXXXXXXXXXXXXXXXXXXXXXXXXXXXXXXXXXXXXXXXXXXXXX----XXX---XXXXXX
SXXXXXXXXXXXXXXXXXXXXXXXXXXXXXXXXXXXX---XXXXXXXXXXXXXXXXXX---XXXXXXX---XXXXXXXXXXXXXXXXXXXXXXXXXXXXXXXXXXXXXXXXXXXXXXXXXXXXXXXXXXXXXXXXXXXXXX---XXXXXX
