------------------------------------------------------------------------------------------------------------------------------------------------------
------------------------------------------------------------------------------------------------------------------------------------------------------
------------------------------------------------------------------------------------------------------------------------------------------------------
------------------------------------------------------------------------------------------------------------------------------------------------------
------------------------------------------------------------------------------------------------------------------------------------------------------
------------------------------------------------------------------------------------------------------------------------------------------------------
------------------------------------------------------------------------------------------------------------------------------------------------------
------------------------------------------------------------------------------------------------------------------------------------------------------
--------------------------------------------------------------------------------------------oSSSooo---------------------------------------------------
-----------------------------------------------------------------------------------------------------------------------------------------------oooSoo-
---------------------oSooS-------%%%%-------------------------Tt---------ooo----------------oooooo----------------------------------------------------
--------------ooSo---------------|k||-------------------------Tt-----------------------------gg---g----------------------oSS-----------------ooooooo--
-----------------------ooo----XXXXXXXXXX------------------XXXXXXXXXXXXXXXXXXXXX--XXXX-ooo--XXXXXXXXX-------XXXXX----oo--------------y-----------------
--------------ooooo--------r--XXXXXXXXXX------------------XXXXXXXXXXXXXXXXXXXXX--XXXX--r---XXXXXXXXX-------XXXXX--------ooooo-----XXXXXXX---XXXXXXXXXX
XXXXXXXXXX-----y----XXXXXXXXXXXXXXXXXXXXXXXXX--XXXXXXX--XXXXXXXXXXXXXXXXXXXXXXX--XXXXXXXXXXXXXXXXXXXXXXX---XXXXXXXXXXXX-----------XXXXXXXXXXXXXXXXXXXX
XXXXXXXXXXXXXXXXXXXXXXXXXXXXXXXXXXXXXXXXXXXXX--XXXXXXX--XXXXXXXXXXXXXXXXXXXXXXXXXXXXXXXXXXXXXXXXXXXXXXXXXXXXXXXXXXXXXXXXXXXXXXXXXXXXXXXXXXXXXXXXXXXXXX
S----SSSSSSSSSSSSSSSSSSSSSSSSSSSSSSSSSSSSSSSSSSSSSSSSSSSSSSSSSSSSSSSSSSSSSSSSSSSSSSSSSSSSSSSSSSSSSSSSSSSSSSSSSSSSSSSSSSSSSSSSSSSSSSSSSSSSSSSSSSSSSSSSS
S----SSSSSSSSSSSSSS------SSSSSSSSSSSSSSSSSSSSSSSSSSSSSSSSSSSSSSSSSSSSSSSSSSSSSSSSSSSSSSSSSSSSSSSSSSSSSS------------SSSSSSSSSSSSSSSSSSSSSSSSSSSSSSSSSSS
S----SSSSSS--------------SSSSSSSSSSSSSSSSSSS-------SSSSSSSSSSSSSSSSSSSSSSSSSSS------SSSSSSSSSSSSSSSSSSS-----------------------------------------------
S------------------------SSSSSS--------------------------SSSSSSSS-------------------SSSSSSSS------SSSSS-----------------------------------------------
S-----------------------------------------------------------------------------------------------------------------------------------------------------
S-----------------------------------------------------------------------------------------------------------------------------------------------------
S-----------------------------------------------------------------------------------------------------------------------------------------------------
S-----------------------------------------------------------------------------------------------------------------------------------------------------
S-----------------------------------------------------------------------------------------------------------------------------------------------------
S----------------------------------------------------------------------------------ooo---------------------------Soo-----------ooSSo------------------
S-------------------------oo------------------------------------ooSooo---------------------------oooo-------------------------------------ooSoS-------
S------------oo---------------------------------------oSoo--------------oSS--------ooo-------------------------oooo------y-------ooo------------------
S---------------------XXXXXXXXX----r--------------------------oooooo-----------XXX-k-------------ooo------------------XXXXXXX--------g-----ooooo------
S-----------XXXXXXXXXXXXXXXXXXXXXXXXX--ooo------------oo------------rr----oo---XXXXXXXXXXXXXXX-k------XXXXXXXXXXXXXXXXXXXXXXXXXXXXXXXXXX---------XXXXX
SXXXXXXXXXXXXXXXXXXXXXXXXXXXXXXXXXXXX---------XXXX----------XXXXXXXXXXX--------XXXXXXXXXXXXXXXXXXXXXXXXXXXXXXXXXXXXXXXXXXXXXXXXXXXXXXXXXXXXXXXXXXXXXXX
SXXXXXXXXXXXXXXXXXXXXXXXXXXXXXXXXXXXXXXXXXXXXXXXXXXXXXXXXXXXXXXXXXXXXXXXXXXXXXXXXXXXXXXXXXXXXXXXXXXXXXXXXXXXXXXXXXXXXXXXXXXXXXXXXXXXXXXXXXXXXXXXXXXXXX
