S----SSSSSSSSSSSSSSSSSSSSSSSSSSSSSSSSSSSSSSSSSSSSSSSSSSSSSSSSSSSSSSSSSSSSSSSSSSSSSSSSSSSSSSSSSSSSSSSSSSSSSSSSSSSSSSSSSSSSSSSSSSSSSSSSSSSSSSSSSSSSSSSSS
S----SSSSSSSSSSSSSSSSSSSSSS------SSSSSSSSSSSSSSSSSSSSSSSSSSSSSSS-----SSSSSSSSSSSSSSSSSSSSSSSSSSSSSSSS-----SSSSSSSSSSSSSSSSSSSSSSSS------------------SS
S-----------SSSSSSSSSSSSSSS------SSSSSSSSSSSSSSSSSSSSSSSSSSSSSSS----------SSSSSSSSSSSSSSSSSSSSSS----------SSSSSSSS------SSSSS-------------------------
S--------------------------------SSSSSSSS---------------------------------SSSSSS----------------------------------------SSSSS-------------------------
S-----------------------------------------------------------------------------------------------------------------------------------------------------
S-----------------------------------------------------------------------------------------------------------------------------------------------------
S-----------------------------------------------------------------------------------------------------------------------------------------------------
S-----------------------------------------------------------------------------------------------------------------------------------------------------
S-----------------------------------------------------------------------------------------------------------------------------------------------------
S-------------SSooo----------------------------------------------------ooSSoo--------------------------------ooo--------------------------------------
S-----------------------------------------------------------------------------------------oSSoooo-----------------------------------------------------
S---------------oo------------------oooo-----ooo------ooo---------------ooooooo--------------------------------------------oooo-----------------------
S-----------------y-----------------------------k-------y----------XX--r-----k--XXX----------oooo------------------------------------------------XX---
S-----------XXXXXXXXXX----------XX---oooooo-XXXXXXXXXXXXXXXX-ooo---XXXXXXXXXXXXXXXX----------r---gg-XXX----XXXXXXXX------XXXXXXX-----------oo----XX---
S-----------XXXXXXXXXX----------XX----------XXXXXXXXXXXXXXXX-------XXXXXXXXXXXXXXXXXXXXXXXXXXXXXXXXXXXX----XXXXXXXX------XXXXXXX------XXXX-------XXXXX
SXXXXXXXXXXXXXXXXXXXXXXXXXXXXXXXXXXXXXXXXXXXXXXXXXXXXXXXXXXXXXXXXXXXXXXXXXXXXXXXXXXXXXXXXXXXXXXXXXXXXXXXXXXXXXXXXXXXXXXXXXXXXXXXXXXXXXXXXXXXXXXXXXXXXX
