S----SSSSSSSSSSSSSSSSSSSSSSSSSSSSSSSSSSSSSSSSSSSSSSSSSSSSSSSSSSSSSSSSSSSSSSSSSSSSSSSSSSSSSSSSSSSSSSSSSSSSSSSSSSSSSSSSSSSSSSSSSSSSSSSSSSSSSSSSSSSSSSSSS
S----SSSSSSSSSSSSSSSSSSSSSSSSSSSSSSSSSSSSSSSSSSSSSSSSSSSSS----------------SSSSSS-------SSSSSSS-----------------SSSSSSSSSSSSSSSSSSSSSSSSSSSSSSSSSS-----
S----SSSSSSSSSSSSS--------------SSSSSSSSSSSSSSSSSSSSSSSSSS----------------SSSSSS-------SSSSSSS-----------------SSSSSSSSSSS--------SSSSSSSSSSSSSSS-----
S----SSSSS----------------------SSSSSSSSSSSSSSSSSSSSSSSSSS-----------------------------------------------------SSSSSS---------------------SSSSSSS-----
S-----------------------------------------------------------------------------------------------------------------------------------------------------
S-----------------------------------------------------------------------------------------------------------------------------------------------------
S-----------------------------------------------------------------------------------------------------------------------------------------------------
S-----------------------------------------------------------------------------------------------------------------------------------------------------
S-------------------------------------------oooo------------------------------------------------------------------------------------------------------
S--------------------------------------------------------------------------------------------oSoo-----------------------------------------------------
S---------------oSoo---------Soo--------------ooo----------------ooooo-----oooooo--------------------------SoS----------------------------------------
S-------------------------------------------y----------ooo------------------------------------ooo-------------------------oo-----ooo---------oSo------
S--------------------------oooooooo---XXXXXXXXXXXXX--------XXXX---oooooo-----oooo----XXXXXXX--r---XXXXXXX--ooo----XXXXXX-----------k--g-------------XX
SXXXXXXXXXXXXX-----k------------------XXXXXXXXXXXXX-ooo----XXXX-----ky-------y-------XXXXXXXXXXXXXXXXXXXX---------XXXXXXXXXXXXXXXXXXXXXX------ooooo-XX
SXXXXXXXXXXXXXXXXXXXXXXXXXXXXXXXXXXXXXXXXXXXXXXXXXX-G------XXXXXXXXXXXXXXXXXXXXXXXXXXXXXXXXXXXXXXXXXXXXXXXXXXXXXXXXXXXXXXXXXXXXXXXXXXXXXXX-k--------XX
SXXXXXXXXXXXXXXXXXXXXXXXXXXXXXXXXXXXXXXXXXXXXXXXXXXXXXXXXXXXXXXXXXXXXXXXXXXXXXXXXXXXXXXXXXXXXXXXXXXXXXXXXXXXXXXXXXXXXXXXXXXXXXXXXXXXXXXXXXXXXXXXXXXXXX
