S----SSSSSSSSSSSSSSSSSSSSSSSSSSSSSSSSSSSSSSSSSSSSSSSSSSSSSSSSSSSSSSSSSSSSSSSSSSSSSSSSSSSSSSSSSSSSSSSSSSSSSSSSSSSSSSSSSSSSSSSSSSSSSSSSSSSSSSSSSSSSSSSSS
S----SSSSSSSS------SSSSSSSSSSSSSSSSSSSSSS-------SSSSSSSSSSSSSSSSSSSSSSSSSSSSSSSSSS-------SSSSSSSSSSSSSSSS---------------------SSSSSSSS------SSSSSSSSSS
S----SSSSSSSS------SSSSSSSS---------------------SSSSSSSSSSSSSSSSSSSSSSSSSSSSSSSSSS-------SSSSSSSSSSSSSSSS---------------------SSSSSSSS------SSSSSSSS--
S------------------SSSSSSSS---------------------SSSSSS--------SSSSSSSS---------------------------SSSSSSSS---------------------------------------------
S-----------------------------------------------------------------------------------------------------------------------------------------------------
S-----------------------------------------------------------------------------------------------------------------------------------------------------
S-----------------------------------------------------------------------------------------------------------------------------------------------------
S-----------------------------------------------------------------------------------------------------------------------------------------------------
S-----------------------------------------------------------------------------------------------------------oooooo---------------oooo--oSooo----------
S----------oooSSSoo---------------------oSo-----SoooSoo----------------------------oooSo--------------------------------------------------------------
S-------------------------------------------------------------------------SoS---------------------------------ooo------oSoo-----oo------oooo----------
S----------ooooooo-------------------ooooo-------oooooo----------------------------ooooo-----------------------------------------k--------------oSooo-
S-------------------------------------------------gk------XXXXXX---------oo-----------R----------------XXXXXXXXXXXXX---ooooo---XXXXXXXXXXXXXX---------
S---------XXXXXXXXXXXXXXXX-------XXXXXXXXXXXXXXXXXXXXXXXXXXXXXXX-----------rr--XXXXXXXXXXXXXXXXXXXX----XXXXXXXXXXXXX---g-------XXXXXXXXXXXXXXXX-------
SXXXXXXXXXXXXXXXXXXXXXXXXXXXXX---XXXXXXXXXXXXXXXXXXXXXXXXXXXXXXX---XXXXXXXXXXXXXXXXXXXXXXXXXXXXXXXXXXXXXXXXXXXXXXXXXXXXXXXXXXXXXXXXXXXXXXXXXXXX---r---
SXXXXXXXXXXXXXXXXXXXXXXXXXXXXXXXXXXXXXXXXXXXXXXXXXXXXXXXXXXXXXXXXXXXXXXXXXXXXXXXXXXXXXXXXXXXXXXXXXXXXXXXXXXXXXXXXXXXXXXXXXXXXXXXXXXXXXXXXXXXXXXXXXXXXX
