S----SSSSSSSSSSSSSSSSSSSSSSSSSSSSSSSSSSSSSSSSSSSSSSSSSSSSSSSSSSSSSSSSSSSSSSSSSSSSSSSSSSSSSSSSSSSSSSSSSSSSSSSSSSSSSSSSSSSSSSSSSSSSSSSSSSSSSSSSSSSSSSSSS
S----SSSSSS-------SSSSSSSSSSSSS--------SSSSSSSSSSSSSSSSS-------------SSSSSSSS------SSSSSSSSSSSSSSSSSSSSS------SSSSSSSSSSSSSSSSSSSSSSSS-------SSSSSSSSS
S----SSSSSS-------SSSSSSS--------------SSSSS-------SSSSS---------------------------SSSSSSSSSSSSSSSS-----------SSSSSSS---------------------------------
S--------------------------------------------------SSSSS---------------------------SSSSSS-----SSSSS-----------SSSSSSS---------------------------------
S-----------------------------------------------------------------------------------------------------------------------------------------------------
S-----------------------------------------------------------------------------------------------------------------------------------------------------
S-----------------------------------------------------------------------------------------------------------------------------------------------------
S-----------------------------------------------------------------------------------------------------------------------------------------------------
S----------------------------------------------------------------------------------oSooo--------------------------------------------------------------
S-----------------------------------------------oSSSo-------------------------------------------------------------------------------------------------
S-------------oooo--------------------------------------------------------------ooooooooo--ooooooS----------------------------------------------------
S-------------------------------ooo--------------ooo-------------------------------------------------------------------oooSo--------------------------
S---------------oo------------------------XXXX-kg------------------------------XXXXXXXXXXX---oooooo-----XXXXX----XXX--------------------------------XX
S-------------------------XXXXX--ooo--XXXXXXXXXXXXXXXXX---oo-XXXXX------XXXXX--XXXXXXXXXXX-----k-r------XXXXX----XXX---ooooo--------ooooo-----------XX
S-----------XXXXXXXXXXXXXXXXXXX-------XXXXXXXXXXXXXXXXX------XXXXXXXXXXXXXXXX--XXXXXXXXXXXXXXXXXXXXXXXXXXXXXX----XXX-k--------------------------XXXXXX
SXXXXXXXXXXXXXXXXXXXXXXXXXXXXXXXXXXXXXXXXXXXXXXXXXXXXXXXXXXXXXXXXXXXXXXXXXXXXXXXXXXXXXXXXXXXXXXXXXXXXXXXXXXXXXXXXXXXXXXXXXXXXXXXXXXXXXXXXXXXXXXXXXXXXX
