S----SSSSSSSSSSSSSSSSSSSSSSSSSSSSSSSSSSSSSSSSSSSSSSSSSSSSSSSSSSSSSSSSSSSSSSSSSSSSSSSSSSSSSSSSSSSSSSSSSSSSSSSSSSSSSSSSSSSSSSSSSSSSSSSSSSSSSSSSSSSSSSSSS
S------------SSSSSSSSSSSSSSSSSSSSSSSSSSSSSSSSSS-------------SSSSSSSSSSSSSSS----------SSSSSSS-------SSSSSSSSSSSSSSS-----SSSSSSSSSSSSSSSSSSSSSSS--------
S------------SSSSSSSSSSSSSSSSSSSSSSSSSSSSSSSSSS-------------SSSSSSSS-----------------SSSSSSS-------SSSSSSSSSSSSSSS----------SSSSSSS-------------------
S------------------SSSSSSSS-----SSSSSSS---------------------SSSSSSSS---------------------------------------SSSSSSS------------------------------------
S-----------------------------------------------------------------------------------------------------------------------------------------------------
S-----------------------------------------------------------------------------------------------------------------------------------------------------
S-----------------------------------------------------------------------------------------------------------------------------------------------------
S-----------------------------------------------------------------------------------------------------------------------------------------------------
S-------------oooo--------------SoSS---------oSooo----------------------------------------------------------------------------------------------------
S-----------------------------------------------------------------------------------------------------------------------------------------------------
S-------------oooo----oooo-----oooooo------ooooooo----------------------------------------------------------------Sooooo----ooSooo--------------------
S------------r-----------------------------------------oSo-------------oooS-----ooo---------------SoS--------------------------------------------ooo--
S-----------XXXXXXXXX---------XXXXXXXXX---XXXXXXXXXXX-----------XXX-------------------------------------------------ooooo-----oo----------------------
SXXXXXXXXXXXXXXXXXXXX---k-----XXXXXXXXXXXXXXXXXXXXXXX---ooooo---XXXXXX-oooo--XXXXXXX-------------oooo------oo----------y-----------------------XXXXXXX
SXXXXXXXXXXXXXXXXXXXXXXXXXXXXXXXXXXXXXXXXXXXXXXXXXXXX--y-g------XXXXXX-Y-----XXXXXXXXXXXX--r-----R--------------XXXXXXXXXXXXXXXXXXXXXXXXXX-----XXXXXXX
SXXXXXXXXXXXXXXXXXXXXXXXXXXXXXXXXXXXXXXXXXXXXXXXXXXXXXXXXXXXXXXXXXXXXXXXXXXXXXXXXXXXXXXXXXXXXXXXXXXXXXXXXXXXXXXXXXXXXXXXXXXXXXXXXXXXXXXXXXXXXXXXXXXXXX
