S----SSSSSSSSSSSSSSSSSSSSSSSSSSSSSSSSSSSSSSSSSSSSSSSSSSSSSSSSSSSSSSSSSSSSSSSSSSSSSSSSSSSSSSSSSSSSSSSSSSSSSSSSSSSSSSSSSSSSSSSSSSSSSSSSSSSSSSSSSSSSSSSSS
S----SSSSSSSSSSSSS---------------SSSSSSSSSSSSSSS------------SSSSSSSSSSSSSSS-----SSSSSSSSSSSSSSSSSSSSSSSSSSSSSSSSSSSSSSSSSSSSSSSSSSSSSSSSSSSSSSSSS-----
S----------------------------------------SSSSSSS-------------------SSSSSSSS-----SSSSSSSS-----SSSSSSSSSSSSSSSSSSSSSSSSS--------------SSSSSSSS----------
S---------------------------------------------------------------------------------------------------------SSSSSS--------------------------------------
S-----------------------------------------------------------------------------------------------------------------------------------------------------
S-----------------------------------------------------------------------------------------------------------------------------------------------------
S-----------------------------------------------------------------------------------------------------------------------------------------------------
S-----------------------------------------------------------------------------------------------------------------------------------------------------
S-----------------------------SooSoS------------------------------------------------------------------------------------------------------------------
S--------------------------------------------------------------------oooooo---------------------------------------------ooooo-----Sooo----------------
S-----------------------------oooo--------------------------------------------------------------------------------------------------------------------
S-------------g------ooo-----------g-----------------------------------ooo-----------------------------------------------ooo-----ooo----------oooooo--
S-----------XXXXXX----------XXXXXXXXXX-------------------------------k-----------------------------------------------XX-------------y-----------------
S-----------XXXXXXXXXXXXXX--XXXXXXXXXXXX-----XXXXX--XXXXXX--XXXXX---XXXXXXXXXXXX----------------------ooo----------XXXXXXXXXXXXXXXXXXXXX--------ooo---
SXXXXXXXXXXXXXXXXXXXXXXXXX--XXXXXXXXXXXXXXXXXXXXXX--XXXXXX--XXXXXXXXXXXXXXXXXXXXXXXXX-----XXXXXX-----------------XXXXXXXXXXXXXXXXXXXXXXXXXXXX-----yr--
SXXXXXXXXXXXXXXXXXXXXXXXXXXXXXXXXXXXXXXXXXXXXXXXXXXXXXXXXXXXXXXXXXXXXXXXXXXXXXXXXXXXXXXXXXXXXXXXXXXXXXXXXXXXXXXXXXXXXXXXXXXXXXXXXXXXXXXXXXXXXXXXXXXXXX
