S----SSSSSSSSSSSSSSSSSSSSSSSSSSSSSSSSSSSSSSSSSSSSSSSSSSSSSSSSSSSSSSSSSSSSSSSSSSSSSSSSSSSSSSSSSSSSSSSSSSSSSSSSSSSSSSSSSSSSSSSSSSSSSSSSSSSSSSSSSSSSSSSSS
S----SSSSSSSSSSSSS-------SSSSSSSSSSSSSS-------SSSSSSSSSSSSSSSSSSSSSSSSSSSSSSSSSSSSSSS-------SSSSSSSSSSSSSSSSSSSSSSSSSSSSSS--------SSSSSSSSSSSSSSSSSSSS
S----SSSSSSSSSSSSS---------------SSSSSS-------SSSSSSSSSSSSSSSSSSS-------------SSSSSSS-------SSSSSSSSSSSSSSSSSSSSSSSSSSSSSS---------------------------S
S----SSSSSS-----------------------------------SSSSSSSSSSSSSSSSSSS-------------SSSSSSS------------SSSSSSSS----------SSSSSSS---------------------------S
S-----------------------------------------------------------------------------------------------------------------------------------------------------
S-----------------------------------------------------------------------------------------------------------------------------------------------------
S-----------------------------------------------------------------------------------------------------------------------------------------------------
S-----------------------------------------------------------------------------------------------------------------------------------------------------
S-------------------------------SoS--------------------------------------------------------------------------------------------oooo-------------------
S----------------------------------------------------------------------------------------------------SoSo--------------------------------------oSSSo--
S--------------ooooo-------------ooooo------------------------------oooSoS----------------ooSo--------------SoSoo-------------------------------------
S-------------k---y------------------------oSSo-----------ooSS--------------------------------------ooo-------------------------R------ooSS-----------
SXXXXXXXXXXXXXXXXXXXX-oooo---XXXXXXXXXX-----------------------------ooooo----XXXXXX-oooo---oo--XXX----y-g--oooooo-------------XXXXXX-------------g----
SXXXXXXXXXXXXXXXXXXXX--------XXXXXXXXXX----oooooo-XXXXX-oooo----XX----k---y--XXXXXX----------g-XXXXXXXXXXX--y-------XX-ooo----XXXXXX-oooooooo-XXXXXXXX
SXXXXXXXXXXXXXXXXXXXXXXXXXXXXXXXXXXXXXX--------g--XXXXX---------XXXXXXXXXXXXXXXXXXXXXXXXXXXXXXXXXXXXXXXXXXXXXXXXXXXXXX------y-XXXXXX----------XXXXXXXX
SXXXXXXXXXXXXXXXXXXXXXXXXXXXXXXXXXXXXXXXXXXXXXXXXXXXXXXXXXXXXXXXXXXXXXXXXXXXXXXXXXXXXXXXXXXXXXXXXXXXXXXXXXXXXXXXXXXXXXXXXXXXXXXXXXXXXXXXXXXXXXXXXXXXXX
