S----SSSSSSSSSSSSSSSSSSSSSSSSSSSSSSSSSSSSSSSSSSSSSSSSSSSSSSSSSSSSSSSSSSSSSSSSSSSSSSSSSSSSSSSSSSSSSSSSSSSSSSSSSSSSSSSSSSSSSSSSSSSSSSSSSSSSSSSSSSSSSSSSS
S----SSSSSSSSSSSSSSSSSSSSSSSSSSSSSSSSSSSSS---------------SSSSSSSSSSSSSSSSSSSSSSSSSSSSSSSSSS--------SSSSSSSS------SSSSSSSSSSSSS-------SSSSSSSSSSSSS----
S----SSSSSSSSSSS-----SSSSSSS------SSSSSSSS---------------SSSSSSSSSSSSSSSSSS-----SSSSSSSSSSS--------SSSSSSSS------SSSSSS-------------------------------
S----SSSSS-----------SSSSSSS-----------------------------------------SSSSSS-----SSSSSSSSSSS--------SSSSSSSS-------------------------------------------
S-----------------------------------------------------------------------------------------------------------------------------------------------------
S-----------------------------------------------------------------------------------------------------------------------------------------------------
S-----------------------------------------------------------------------------------------------------------------------------------------------------
S-----------------------------------------------------------------------------------------------------------------------------------------------------
S---------------------Soo-------ooooSSoo---oooo-----------------------------------------------------------------------------------------ooSoSo--------
S-------------------------------------------------------------------------------------oSooo-----------------------------------------------------------
S------------ooooo-----oo-------oooooo-------------Sooo-------oSoSo--------------------------------ooooooo---ooooo----------------------oooooo--------
S------------------------ky-----------------r-------------------------------oSo-------ooooo------------y-------r-----------------------k---r--y-------
S------------------XXXXXXXXXX--XXXXXXXXXXXXXXXXX---------------ooo------------------g-------------XXXXXXXXXXXXXXXXXX--ooo------------XXXXXXXXXXX------
S------------------XXXXXXXXXX--XXXXXXXXXXXXXXXXX---k------XX--------------ooo---XXXXXXXXXXXXX-----XXXXXXXXXXXXXXXXXX----y--------oo--XXXXXXXXXXXXXX---
SXXXXXXXXXXXXXXXXXXXXXXXXXXXX--XXXXXXXXXXXXXXXXXXXXXXXXX--XXXXXXXXXXXXXX--------XXXXXXXXXXXXX-----XXXXXXXXXXXXXXXXXXXXXXXX------g----XXXXXXXXXXXXXXXXX
SXXXXXXXXXXXXXXXXXXXXXXXXXXXXXXXXXXXXXXXXXXXXXXXXXXXXXXXXXXXXXXXXXXXXXXXXXXXXXXXXXXXXXXXXXXXXXXXXXXXXXXXXXXXXXXXXXXXXXXXXXXXXXXXXXXXXXXXXXXXXXXXXXXXXX
