------------------------------------------------------------------------------------------------------------------------------------------------------
------------------------------------------------------------------------------------------------------------------------------------------------------
------------------------------------------------------------------------------------------------------------------------------------------------------
------------------------------------------------------------------------------------------------------------------------------------------------------
------------------------------------------------------------------------------------------------------------------------------------------------------
------------------------------------------------------------------------------------------------------------------------------------------------------
------------------------------------------------------------------------------------------------------------------------------------------------------
--------------------------------------------------------------------------------------------------------%%%%%%%---------------------------------------
--------------------------------------------------------------------------------------------------------|||||||---------------------------------------
---------------ooooSSSo--------------------------------------------------------------oSS----------------||%%%||---------------------------------------
--------------------------------------tt-----Soooo-------oSoooSoo------ooo----oo------------------------|||||||---------------------------------------
-----------------ooo-------------tt---tt----------------------------------y----K-----oo-----------------k|k||||---------------------------------------
------------------R-----XXXXX----tt---tt-----ooo---------ooooo------XXXXXXXXXXXXXX--------XXXXX---XXXXXXXXXXXXXXX--------------XXXXX----oo------------
--------------XXXXXXXXXXXXXXXXXXXXXXXXXXXX-------------------y------XXXXXXXXXXXXXXXXXXXXXXXXXXX---XXXXXXXXXXXXXXX--------------XXXXX-------XXX--------
XXXXXXXXXXXXXXXXXXXXXXXXXXXXXXXXXXXXXXXXXXXXXXXXXXX----XXXXXXXXXXX--XXXXXXXXXXXXXXXXXXXXXXXXXXX---XXXXXXXXXXXXXXXXXXX--XXXX----XXXXXXXXXXXXXXX--------
XXXXXXXXXXXXXXXXXXXXXXXXXXXXXXXXXXXXXXXXXXXXXXXXXXXXXXXXXXXXXXXXXXXXXXXXXXXXXXXXXXXXXXXXXXXXXXX---XXXXXXXXXXXXXXXXXXX--XXXXXXXXXXXXXXXXXXXXXXXXXXXXXXX
S----SSSSSSSSSSSSSSSSSSSSSSSSSSSSSSSSSSSSSSSSSSSSSSSSSSSSSSSSSSSSSSSSSSSSSSSSSSSSSSSSSSSSSSSSSSSSSSSSSSSSSSSSSSSSSSSSSSSSSSSSSSSSSSSSSSSSSSSSSSSSSSSSS
S----------SSSSSSSSSSSSSS-------SSSSSSSSSSSSSSSSSSSSSSSSSSSSSSSSSSSSSSSSSSSSSS-------SSSSSSSSSSSSSS-----SSSSSSSSSSSSSSSSSSSSSSSSSSS------SSSSSSSSSSSSS
S----------SSSSSSSSSSSSSS-------SSSSSSS-------------SSSSSSSSSSSSSSSSSSS--------------SSSSSSSSSSSSSS-----SSSSSS--------SSSSSSSSSSSSS------SSSSSSSSSSSSS
S-------------------------------SSSSSSS-------------------------SSSSSSS--------------SSSSSSSS-----------SSSSSS--------SSSSSSSSSSSSS------SSSSSSSSSSSSS
S-----------------------------------------------------------------------------------------------------------------------------------------------------
S-----------------------------------------------------------------------------------------------------------------------------------------------------
S-----------------------------------------------------------------------------------------------------------------------------------------------------
S-----------------------------------------------------------------------------------------------------------------------------------------------------
S-----------------------------------------------------------------------------------------------oSooS---------oooooo----------------------------------
S-----------------------------------------------oooSS---------------ooSoo-----------------------------------------------------------------------------
S-------------------------------------ooSoo-------------------------------------------oo--------ooooo---------ooooo---------------------------------*-
S--------------SSooo--------ooo--------------oooooo------SoSooooo----------------------r------------k-----------------------------------------------*-
S---------------------XXXX------------oooo----------------------------y---XXXXX------XXXXXX----XXXXXXXX----XXXXXXXXXXX--------------------------XXXXXX
SXXXXXXXXXXXX---------XXXXXXXXXXXX--R-----r-XXXXXXXXXXX--oooooo---XXXXXXXXXXXXX-oo---XXXXXXXXXXXXXXXXXX----XXXXXXXXXXXXX--------y-----XXXXX-----XXXXXX
SXXXXXXXXXXXX----y----XXXXXXXXXXXXXXXXXXXXXXXXXXXXXXXXX-r---y-r---XXXXXXXXXXXXX------XXXXXXXXXXXXXXXXXXXXXXXXXXXXXXXXXXXXXXXXXXXXXXXXXXXXXX-----XXXXXX
SXXXXXXXXXXXXXXXXXXXXXXXXXXXXXXXXXXXXXXXXXXXXXXXXXXXXXXXXXXXXXXXXXXXXXXXXXXXXXXXXXXXXXXXXXXXXXXXXXXXXXXXXXXXXXXXXXXXXXXXXXXXXXXXXXXXXXXXXXXXXXXXXXXXXX
