S----SSSSSSSSSSSSSSSSSSSSSSSSSSSSSSSSSSSSSSSSSSSSSSSSSSSSSSSSSSSSSSSSSSSSSSSSSSSSSSSSSSSSSSSSSSSSSSSSSSSSSSSSSSSSSSSSSSSSSSSSSSSSSSSSSSSSSSSSSSSSSSSSS
S-------------------SSSSSSS--------SSSSSSSSSSSSS-----SSSSSS-----SSSSSSSSSSSSS-------SSSSSSSSSSSSS-----SSSSSSSSSSSSSSSSSSSSSSSSSSSSSSSSSSSSSSSSSSSSSSSS
S-------------------SSSSSSS--------SSSSSSSSSSSSS-----SSSSSS-----SSSSSSSSSSSSS-------------SSSSSSS-----SSSSSSSSSSSSSSSSSSSSSSSS-----SSSSSSSS--------SSS
S----------------------------------SSSSSSSSSSSSS------------------------------------------SSSSSSS-----SSSSSS-------SSSSSS----------SSSSSSSS--------SSS
S-----------------------------------------------------------------------------------------------------------------------------------------------------
S-----------------------------------------------------------------------------------------------------------------------------------------------------
S-----------------------------------------------------------------------------------------------------------------------------------------------------
S-----------------------------------------------------------------------------------------------------------------------------------------------------
S--------------------------------------------------------oSoo------------------------------ooSSS------------------------------------------------------
S-------------------------------------------------------------------ooSoooo---------------------------------------------------------------------------
S------------------------------------------------oSoSo---oooooo----------------------------ooooo----------------------------oo------------------------
S-------------------------------SSoSo--------------------------------ooooo----------------------y-----------oooo-----------------------Soo------------
S-----------XXX-----------XXX--------------------ooooo-XXXXXXXXX------r-k-----XXXX------XXXXXXXXXXXXXXXX---r--------ooo--XXXXXX-------------XXXXXX----
SXXXXXXXXXXXXXXXXXXXXX----XXX---oooo-------------------XXXXXXXXXXXXXXXXXXXXXXXXXXX----XXXXXXXXXXXXXXXXXXXXXXXXXXXX-------XXXXXXXXXX---ooo---XXXXXX----
SXXXXXXXXXXXXXXXXXXXXXXXXXXXX----r----XXXXX----XXXXXXXXXXXXXXXXXXXXXXXXXXXXXXXXXXX----XXXXXXXXXXXXXXXXXXXXXXXXXXXXXXXXXXXXXXXXXXXXX----G----XXXXXXXXXX
SXXXXXXXXXXXXXXXXXXXXXXXXXXXXXXXXXXXXXXXXXXXXXXXXXXXXXXXXXXXXXXXXXXXXXXXXXXXXXXXXXXXXXXXXXXXXXXXXXXXXXXXXXXXXXXXXXXXXXXXXXXXXXXXXXXXXXXXXXXXXXXXXXXXXX
