S----SSSSSSSSSSSSSSSSSSSSSSSSSSSSSSSSSSSSSSSSSSSSSSSSSSSSSSSSSSSSSSSSSSSSSSSSSSSSSSSSSSSSSSSSSSSSSSSSSSSSSSSSSSSSSSSSSSSSSSSSSSSSSSSSSSSSSSSSSSSSSSSSS
S----SSSSSS------------------SSSSSSSSSSSSSSSSSSSSSSSSSSSSSSSSSSSSSSSSSSSSSSSSSSSSSSSSSSSSSSSSSSSSSS-----SSSSSSSSSSSSSSS-----SSSSSSSS-----SSSSSSSSSSSSS
S----SSSSSS------------------SSSSSSSSSSSSSSSSSSS--------------------SSSSSSSSSSSSSSSSSSSS------SSSSS-------------SSSSSSS-----SSSSSSSS----------SSSSSSSS
S----SSSSSS------------------SSSSSSSSSSSSSS--------------------------------SSSSSSSS-----------SSSSS-------------------------------------------------SS
S-----------------------------------------------------------------------------------------------------------------------------------------------------
S-----------------------------------------------------------------------------------------------------------------------------------------------------
S-----------------------------------------------------------------------------------------------------------------------------------------------------
S-----------------------------------------------------------------------------------------------------------------------------------------------------
S-------------------------------oSooS--------------------------ooSooSSS--------------------------------------------------------SSS-------ooooo--------
S-----------------------------------------------------------------------------------------------------------------------------------------------------
S---------------------------------------oooS----------Soooo------oooo----------------------------------oooSSo------------------------------ooo--------
S--------------oooooo-------------------------------------------------------------ooSoo----------------------------SSoooS--------------------------oo-
S----------------------XXXXXXXXXXXXXXXX-ooooooo------ooooooo--XXXXXXXXXXX-----------------XXXXXXX-------oooooooo------------XXXXXXXX----XXXXXXX-------
S----------------ooo---XXXXXXXXXXXXXXXX---------XXX---R-------XXXXXXXXXXXXXXXXX--oooooooo-XXXXXXX-----------r-------oooooo--XXXXXXXXXXXXXXXXXXXXXXXXXX
S----------------------XXXXXXXXXXXXXXXXXXXXXXXXXXXXXXXXXXXXXXXXXXXXXXXXXXXXXXXX-yy--------XXXXXXXXX---XXXXXXXXXXX----kK-k---XXXXXXXXXXXXXXXXXXXXXXXXXX
SXXXXXXXXXXXXXXXXXXXXXXXXXXXXXXXXXXXXXXXXXXXXXXXXXXXXXXXXXXXXXXXXXXXXXXXXXXXXXXXXXXXXXXXXXXXXXXXXXXXXXXXXXXXXXXXXXXXXXXXXXXXXXXXXXXXXXXXXXXXXXXXXXXXXX
