------------------------------------------------------------------------------------------------------------------------------------------------------
------------------------------------------------------------------------------------------------------------------------------------------------------
------------------------------------------------------------------------------------------------------------------------------------------------------
------------------------------------------------------------------------------------------------------------------------------------------------------
------------------------------------------------------------------------------------------------------------------------------------------------------
------------------------------------------------------------------------------------------------------------------------------------------------------
------------------------------------------------------------------------------------------------------------------------------------------------------
--------------------------------------------------------------------------------------------------------%%%%%%%---------------------------------------
--------------------------------------------------------------------------------------------------------|||||||---------------------------------------
---------------ooooSSSo--------------------------------------------------------------oSS----------------||%%%||---------------------------------------
--------------------------------------tt-----Soooo-------oSoooSoo------ooo----oo------------------------|||||||---------------------------------------
-----------------ooo-------------tt---tt----------------------------------y----K-----oo-----------------k|k||||---------------------------------------
------------------R-----XXXXX----tt---tt-----ooo---------ooooo------XXXXXXXXXXXXXX--------XXXXX---XXXXXXXXXXXXXXX--------------XXXXX----oo------------
--------------XXXXXXXXXXXXXXXXXXXXXXXXXXXX-------------------y------XXXXXXXXXXXXXXXXXXXXXXXXXXX---XXXXXXXXXXXXXXX--------------XXXXX-------XXX--------
XXXXXXXXXXXXXXXXXXXXXXXXXXXXXXXXXXXXXXXXXXXXXXXXXXX----XXXXXXXXXXX--XXXXXXXXXXXXXXXXXXXXXXXXXXX---XXXXXXXXXXXXXXXXXXX--XXXX----XXXXXXXXXXXXXXX--------
XXXXXXXXXXXXXXXXXXXXXXXXXXXXXXXXXXXXXXXXXXXXXXXXXXXXXXXXXXXXXXXXXXXXXXXXXXXXXXXXXXXXXXXXXXXXXXX---XXXXXXXXXXXXXXXXXXX--XXXXXXXXXXXXXXXXXXXXXXXXXXXXXXX