S----SSSSSSSSSSSSSSSSSSSSSSSSSSSSSSSSSSSSSSSSSSSSSSSSSSSSSSSSSSSSSSSSSSSSSSSSSSSSSSSSSSSSSSSSSSSSSSSSSSSSSSSSSSSSSSSSSSSSSSSSSSSSSSSSSSSSSSSSSSSSSSSSS
S----SSSSSSSSSSSSSSSSSSSSSSS-------SSSSSS------SSSSSSSSSSSSSSSSSSSSSS--------SSSSSSS-----SSSSSSSSSSSSSS-----SSSSSSSSSSSSSSSSSSSSSSSSSSSSSSSSSSSSSSSSSS
S----SSSSSSSSSSS-----SSSSSSS-------SSSSSS------SSSSSSSSSSSSSSSSSSSSSS--------SSSSSSS-----SSSSSSSSSSSSSS-----SSSSSSSSSSSSSSSSSSS--------------SSSSSSSSS
S----SSSSSSSSSSS-------------------SSSSSS------SSSSSSSSSSSSSSS---------------------------SSSSSSSSSSSSSS------------SSSSSSS----------------------------
S-----------------------------------------------------------------------------------------------------------------------------------------------------
S-----------------------------------------------------------------------------------------------------------------------------------------------------
S-----------------------------------------------------------------------------------------------------------------------------------------------------
S-----------------------------------------------------------------------------------------------------------------------------------------------------
S-----------------------------------------------------------------------------------------------------oooooooo----------------------------------------
S---------------------------------------------------------------------------------------------SSS-----------------------------------------------------
S---------------oo-------------------------oSoo------oooSSo---SSo-------------------------------------ooooooo-----oSoooS------------------------------
S--------------------------------SSoo--------------------------------------------------------ooo-----r--y-------------------oooSoo------------ooSoo---
SXXXXXXXXXXXXXXXXXXXXX--------------------ooooo----ooooo------ooooo-------------*-------XXXX-kg-----XXXXXXXXXXX---oooooo------------------------------
SXXXXXXXXXXXXXXXXXXXXXXXXXXXXXX--ooooooo-------y--------k----k---r--------y--k--*-------XXXXXXXXXXXXXXXXXXXXXXXXX------------oooo-----------ooooo-----
SXXXXXXXXXXXXXXXXXXXXXXXXXXXXXX----------XXXXXXXXXXXXXXXXXXXXXXXXXXXX----XXXXXX-*-------XXXXXXXXXXXXXXXXXXXXXXXXXXXXXXXXXXX-------g--------r---------X
SXXXXXXXXXXXXXXXXXXXXXXXXXXXXXXXXXXXXXXXXXXXXXXXXXXXXXXXXXXXXXXXXXXXXXXXXXXXXXXXXXXXXXXXXXXXXXXXXXXXXXXXXXXXXXXXXXXXXXXXXXXXXXXXXXXXXXXXXXXXXXXXXXXXXX
