S----SSSSSSSSSSSSSSSSSSSSSSSSSSSSSSSSSSSSSSSSSSSSSSSSSSSSSSSSSSSSSSSSSSSSSSSSSSSSSSSSSSSSSSSSSSSSSSSSSSSSSSSSSSSSSSSSSSSSSSSSSSSSSSSSSSSSSSSSSSSSSSSSS
S----SSSSSSSSSSSSSSSSSSSSSSSSSSSSS-----SSSSSSSSSSSSSSSSSSSSSSS----------------SSSSSSS------SSSSSSSSSSSSS------SSSSSSSSSSSSSSSSSSSSSSSSSSSSSSSSSSSSSSSS
S----SSSSSSSS--------SSSSSS-----------------SSSSSSSSSSSSS---------------------SSSSSSS------SSSSSSSS-----------------SSSSSSSSSSSSS-------------SSSSSSSS
S--------------------SSSSSS-----------------SSSSSSSSSSSSS---------------------SSSSSSS-------------------------------SSSSSSSSSSSSS-------------SSSSSSSS
S-----------------------------------------------------------------------------------------------------------------------------------------------------
S-----------------------------------------------------------------------------------------------------------------------------------------------------
S-----------------------------------------------------------------------------------------------------------------------------------------------------
S-----------------------------------------------------------------------------------------------------------------------------------------------------
S-------------------------------------oSooSo---------------------ooS---------------------------------oooSo--------------------------------------------
S------------oooSoSooo-----------------------------------oSSSo------------------------------------------------ooSSo---------------------------ooSS----
S----------------------------SSo-----ooooooo-----------------------------SSoSo-----ooo--------------oooooo------------ooo--ooo------------------------
S---------------ooo-----------------------k------SooS-----oooo----------------------------------------------oooooo----------------oooooooo----ooooo---
S--------------k-----------oooo----XXXXXXXXXX-------------------XXXXXXX----oo----------------------XXXXXXXX-----y---------XXXXXX-------------k--------
SXXXXXXXXXXXXXXXXXXXXXX------------XXXXXXXXXX-oooooooo--XXXXXXXXXXXXXXX-------------r----XXXXXXX---XXXXXXXXXXXXXXXXX----r-XXXXXX----ooooo--XXXXXXXXX--
SXXXXXXXXXXXXXXXXXXXXXXXXXXXXXXXXXXXXXXXXXXXX------k--y-XXXXXXXXXXXXXXXXXXXXXXXXXXXXXXXXXXXXXXXX---XXXXXXXXXXXXXXXXXXXXXXXXXXXXX-----------XXXXXXXXXXX
SXXXXXXXXXXXXXXXXXXXXXXXXXXXXXXXXXXXXXXXXXXXXXXXXXXXXXXXXXXXXXXXXXXXXXXXXXXXXXXXXXXXXXXXXXXXXXXXXXXXXXXXXXXXXXXXXXXXXXXXXXXXXXXXXXXXXXXXXXXXXXXXXXXXXX
