S----SSSSSSSSSSSSSSSSSSSSSSSSSSSSSSSSSSSSSSSSSSSSSSSSSSSSSSSSSSSSSSSSSSSSSSSSSSSSSSSSSSSSSSSSSSSSSSSSSSSSSSSSSSSSSSSSSSSSSSSSSSSSSSSSSSSSSSSSSSSSSSSSS
S----SSSSSSSSSSSSSSSSS-----SSSSSSSSSSSSSSSSSSSSSSSSSSSSSSSSSSSSSSSSSSSSSSS------SSSSSSSSSSSSSSSS-----SSSSSSSSSSSSSS------------------SSSSSSSSSSSSSSSSS
S----SSSSSSS---------------SSSSSSSSSSSSSSS-------SSSSSSSSSSSSSSSSSSSSSSSSS------SSSSSSSSSSSSSSSS-----SSSSSSSSSSSSSS------------------SSSSSSS-------SSS
S----SSSSSSS---------------SSSSSSS---------------SSSSSSSSSSSSSSSSSSS--------------------SSSSSSSS-------------------------------------SSSSSSS----------
S-----------------------------------------------------------------------------------------------------------------------------------------------------
S-----------------------------------------------------------------------------------------------------------------------------------------------------
S-----------------------------------------------------------------------------------------------------------------------------------------------------
S-----------------------------------------------------------------------------------------------------------------------------------------------------
S--------------------------------------------------------------------------oSSooSS----------------------------------------SoSoo-----------------------
S-------------ooSoSSS-------------------------------------Soo------------------------------------------oooooS-----------------------------------------
S----------------------------------------------------------------------------ooo---------------------------------------ooooooooo----SSS---------------
S----------------ooooo--ooooo----oooooo----------------ooooo------Sooooo----y------------------Soo-----oooo-------------------------------------------
S-----------------k--------gK---------------------XXXX-------------------XXXXXXXXXXX-oooo-----------------------------XXXXXXXXXXX-ooo-------ooo--XXXXX
S------------XXXXXXXXXXXXXXXXXXXXXXXXXXXXX--------XXXXXXXXXXXX---ooooooo-XXXXXXXXXXX--g--------oooo---XXXXXXXXX-------XXXXXXXXXXX--------------r-XXXXX
SXXXXXXXXXXXXXXXXXXXXXXXXXXXXXXXXXXXXXXXXXXXXX----XXXXXXXXXXXX-----------XXXXXXXXXXXXXXXXXXX----------XXXXXXXXXXXXXXXXXXXXXXXXXXXXXXXXXXXXXXXXXXXXXXXX
SXXXXXXXXXXXXXXXXXXXXXXXXXXXXXXXXXXXXXXXXXXXXXXXXXXXXXXXXXXXXXXXXXXXXXXXXXXXXXXXXXXXXXXXXXXXXXXXXXXXXXXXXXXXXXXXXXXXXXXXXXXXXXXXXXXXXXXXXXXXXXXXXXXXXX
