S----SSSSSSSSSSSSSSSSSSSSSSSSSSSSSSSSSSSSSSSSSSSSSSSSSSSSSSSSSSSSSSSSSSSSSSSSSSSSSSSSSSSSSSSSSSSSSSSSSSSSSSSSSSSSSSSSSSSSSSSSSSSSSSSSSSSSSSSSSSSSSSSSS
S----SSSSSSSSSSSSSSSSSSSS-------SSSSSSSSSSSSSSSSSSSSSSSSSSSSSSSSSSSSSSSSSSSSSSSSSSSSSSSS------------SSSSSSSSSSSSSSSSSSSSSSS-------SSSSSSSSSSSSSSSSSSSS
S----------SSSSSS---------------SSSSSSS-------SSSSS-------SSSSSSSSSSSSS------SSSSSSSSSSS------------SSSSSSSS--------SSSSSSS-------SSSSSSSSSSSSSSSSSSSS
S----------SSSSSS------------------------------------------------SSSSSS------------SSSSS------------------------------------------------SSSSSS--------
S-----------------------------------------------------------------------------------------------------------------------------------------------------
S-----------------------------------------------------------------------------------------------------------------------------------------------------
S-----------------------------------------------------------------------------------------------------------------------------------------------------
S-----------------------------------------------------------------------------------------------------------------------------------------------------
S--------------------------------------------------------------------------------------------------------------------------------Soo---------oSoSSSo--
S-------------------------oSoSSS--------------ooSoSoo-----------------------------------------------------------------ooooo---------------------------
S------------------------------------oooo--------------------------------------------------------------------------------------ooooo----------ooooo---
S--------------------------oooooo----------------oo---------------*--*---------------------------------SSSS------------------------K-------------y----
SXXXXXXXXXX-----------------------------------------------------XXXXXXXXXX---------ooo-------XXXX------------------------g----XXXXXXXXX-----XXXXXXXXX-
SXXXXXXXXXX-------------XXXXXXXXXXX----------XXXXXXXXXXXX-------XXXXXXXXXX---------y-g-------XXXXXXXX--------------XXXXXXXXX--XXXXXXXXX-----XXXXXXXXX-
SXXXXXXXXXX-------------XXXXXXXXXXXXXXXXXXXXXXXXXXXXXXXXX-------XXXXXXXXXXXXXX--XXXXXXXXXXXXXXXXXXXXX-G-g----XXXXXXXXXXXXXXX--XXXXXXXXX-----XXXXXXXXX-
SXXXXXXXXXXXXXXX---XXXXXXXXXXXXXXXXXXXXXXXXXXXXXXXXXXXXXXXXXXXXXXXXXXXXXXXXXXXXXXXXXXXXXXXXXXXXXXXXXXXXXXXXXXXXXXXXXXXXXXXXXXXXXXXXXXXXXXXXXXXXXXXXXXX
