------------------------------------------------------------------------------------------------------------------------------------------------------
------------------------------------------------------------------------------------------------------------------------------------------------------
------------------------------------------------------------------------------------------------------------------------------------------------------
------------------------------------------------------------------------------------------------------------------------------------------------------
------------------------------------------------------------------------------------------------------------------------------------------------------
--------------------------------------oo--------------------------------------------------------------------------------------------------------------
---------------------------------------k--------------------------------------------------------------------------------------------------------------
-----------------------------------%%%%%--------------------------------------------------------------------------------------------------------------
-----------------------------------|||||-------------------------------------------------------------------------------------------ooo----------------
-----------------------------------|%%%|--------------------------------------------------------------------------------------------------------------
-------------------oooo------------|||||--------------oooooSo-----------ooo--------------------------------------------------------oo-----------------
---------------------------------r-|k|||---*---*---------------------------------------------oSoSoSooo----g-g---------oooSooo------yy-----------------
-----------------ooooo-------XXXXXXXXXXXXX-*---*--------oo-------------------------------XXX-----------XXXXXXX---------------------%%%----------------
-----------------------------XXXXXXXXXXXXX-*---*---------r----------------------------g--XXX---oooooo--XXXXXXX-------ooooo---------|||----------------
-------------XXXXXXXXXXXXXXXXXXXXXXXXXXXXX-*---*-----XXXXXXXXXXXXXX--XXXXXXX-----XXXXXXXXXXX--y------r-XXXXXXXXXXXX-----gr----XXXX-|y|---------y----XX
XXXXXXXXXXXXXXXXXXXXXXXXXXXXXXXXXXXXXXXXXXXXXXXXXXXXXXXXXXXXXXXXXXXXXXXXXXXXXXXXXXXXXXXXXXXXXXXXXXXXXXXXXXXXXXXXXXXXXXXXXXXXXXXXXXXXXXXXXXXXXXXXXXXXXX