S----SSSSSSSSSSSSSSSSSSSSSSSSSSSSSSSSSSSSSSSSSSSSSSSSSSSSSSSSSSSSSSSSSSSSSSSSSSSSSSSSSSSSSSSSSSSSSSSSSSSSSSSSSSSSSSSSSSSSSSSSSSSSSSSSSSSSSSSSSSSSSSSSS
S----SSSSSSSSSSSSSSSSS-----SSSSSSSSSSSSSSSSSSS-----------SSSSSSSSSSSS----------SSSSSSSSSSSSSSSSSSSSSSSSSSSSSSSSS----------------SSSSSSSSSSSSSSSSSSSSSS
S----SSSSSSS-----SSSSS-----SSSSSSSSSSSSSSSSSSS-----------SSSSSSSSSSSS-----------------------SSSSSSSSSSSSSSSSSSSS----------------SSSSSS-----------SSSSS
S----SSSSSSS---------------------SSSSSSS-----------------------SSSSSS-----------------------SSSSSSSSSSSSSSSSSSSS--------------------------------------
S-----------------------------------------------------------------------------------------------------------------------------------------------------
S-----------------------------------------------------------------------------------------------------------------------------------------------------
S-----------------------------------------------------------------------------------------------------------------------------------------------------
S-----------------------------------------------------------------------------------------------------------------------------------------------------
S--------------------------------------------------------------------SSoS-----------------------------------Soooo-----------------------SSoSoo--------
S----------------------------------------oooS---------------------------------------------------------------------------------------------------------
S-------------------------------ooo--------------------------------oooo-----ooooo---------------------------oooo---oooo---------------oooooooo--------
S-------------oooo---------------------ooooo-------------------------r-----------------ooo---------oooo---------y-----------oSoooooo------g-y----ooo--
SXXXXXXXXX---------------XXXXX--ooooo----k-k----------------------XXXXXXXXX-ooooo-------g--XXXXX--------XXXXXXXXXXXXXXXXXXX----------XXXXXXXXXX-------
SXXXXXXXXX-----oooooo----XXXXX--------XXXXXXXXX---oooo----r-------XXXXXXXXX---y----XXXXXXXXXXXXXXXXXXXXXXXXXXXXXXXXXXXXXXXX-oooooo---XXXXXXXXXXXXXXXXX
SXXXXXXXXXXXX---------XXXXXXXXXXXXXXXXXXXXXXXXX----y---XXXXXXXXXXXXXXXXXXXXXXXXXXXXXXXXXXXXXXXXXXXXXXXXXXXXXXXXXXXXXXXXXXXX-------g--XXXXXXXXXXXXXXXXX
SXXXXXXXXXXXXXXXXXXXXXXXXXXXXXXXXXXXXXXXXXXXXXXXXXXXXXXXXXXXXXXXXXXXXXXXXXXXXXXXXXXXXXXXXXXXXXXXXXXXXXXXXXXXXXXXXXXXXXXXXXXXXXXXXXXXXXXXXXXXXXXXXXXXXX
