S----SSSSSSSSSSSSSSSSSSSSSSSSSSSSSSSSSSSSSSSSSSSSSSSSSSSSSSSSSSSSSSSSSSSSSSSSSSSSSSSSSSSSSSSSSSSSSSSSSSSSSSSSSSSSSSSSSSSSSSSSSSSSSSSSSSSSSSSSSSSSSSSSS
S----SSSSSSSSSSSSSSSSSSS------SSSSSS------SSSSSS-----SSSSSSSSSSSSSSSSSSSSSSSSSSSSSSSSSSSSSSSSSSSSSSSSSSSSSSSSSSSSSSSSSSSSS-------------SSSSSSSSSSSS---
S----------------SSSSSSS------------------SSSSSS-----SSSSSS-------------------SSSSSSS-------SSSSSSSSSSSSSSSSSSSSSSSSSSSSSS-------------SSSSSSSSSSSS---
S-----------------------------------------SSSSSS-----SSSSSS-----------------------------------------SSSSS---------------------------------------------
S-----------------------------------------------------------------------------------------------------------------------------------------------------
S-----------------------------------------------------------------------------------------------------------------------------------------------------
S-----------------------------------------------------------------------------------------------------------------------------------------------------
S-----------------------------------------------------------------------------------------------------------------------------------------------------
S----------------------------------------------------------------------------------Soo-------------------------------oooo-----------------------------
S-------------------------------------------------oSS----------------------------------------------oooo-------------------------------SSo-------------
S-------------*-------------------------------------------------------------------oo------ooSS--------------------------------------------------oSooo-
S----------*--*-----------------------------------ooooo---------ooooo----------------k-----------ooooo------SSoo---------------------oo---------------
SXXXXXXXXX-*--*--*---------------------------------y----------------------------XXXXXXX--oooo------g-r--------------XXXXXX----------------------oooo--
SXXXXXXXXXXXXXXXXXXXXXXXX-ooooo---ooo-----XXXXXXXXXXXXXXXXXXXXXXXXXXXXXXXXXXXXXXXXXXXXX--r-y----XXXXXXXXX--oooooooo-XXXXXX----------XXXXXX--------yk--
SXXXXXXXXXXXXXXXXXXXXXXXX----y------------XXXXXXXXXXXXXXXXXXXXXXXXXXXXXXXXXXXXXXXXXXXXXXXXXXXXXXXXXXXXXXX-------r---XXXXXXXXXXXXXXXXXXXXXX---XXXXXXXXX
SXXXXXXXXXXXXXXXXXXXXXXXXXXXXXXXXXXXXXXXXXXXXXXXXXXXXXXXXXXXXXXXXXXXXXXXXXXXXXXXXXXXXXXXXXXXXXXXXXXXXXXXXXXXXXXXXXXXXXXXXXXXXXXXXXXXXXXXXXXXXXXXXXXXXX
