S----SSSSSSSSSSSSSSSSSSSSSSSSSSSSSSSSSSSSSSSSSSSSSSSSSSSSSSSSSSSSSSSSSSSSSSSSSSSSSSSSSSSSSSSSSSSSSSSSSSSSSSSSSSSSSSSSSSSSSSSSSSSSSSSSSSSSSSSSSSSSSSSSS
S------------SSSSSSSSSSSSSSSSSSSSSSSSSSSSSSSSSSSSSSSSSSSSSSSSSSSSSSSSSSSS--------SSSSSSSSSSSSSSSSSSSSSSSSS--------SSSSSSSSSSSSSSSSSSSSS-----SSSSSSSSSS
S------------SSSSSSSSSSSSSSS--------------SSSSSSSSSSSSSSSSSSSSSSSS---------------SSSSSSSSSSSSSSSSSSSSSSSSS---------------------------------------SSSSS
S------------SSSSSSSSSSSSSSS----------------------SSSSSSSSSSSSSSSS---------------------------SSSSSS---------------------------------------------------
S-----------------------------------------------------------------------------------------------------------------------------------------------------
S-----------------------------------------------------------------------------------------------------------------------------------------------------
S-----------------------------------------------------------------------------------------------------------------------------------------------------
S-----------------------------------------------------------------------------------------------------------------------------------------------------
S-----------------------------------ooSS--------------------------------------------------------------------------------------------------------------
S------------------------------------------------------------------------------------------------------------------------------ooooSSo----------------
S------------------------------------ooo-------------oSooo-------------------------------------------------------------------------------Sooo---------
S----------------SoS--------SoSoo-----r----------------------------------------------ooo----------------------------SSSoooS----oooooo--------------oo-
SXXXXXXXXX------------------------XXXXXXXX---------ooooooo------oo-------------------------ooo----XXX--------XXXXX-------------------k------------y---
SXXXXXXXXXXX------oo-----oooooo---XXXXXXXXXXX------------R------kr--XX--------------ooo---------r-XXXXXXX----XXXXX-oooooo----XXXXXXXXXX----kG--XXXXXXX
SXXXXXXXXXXXXXX---g---------------XXXXXXXXXXXXXXXXXXXXXXXXXXXXXXXXXXXXXXXXXXXXXXX-----g--XXXXXXXXXXXXXXXXXXXXXXXXX------y----XXXXXXXXXXXXXXXXXXXXXXXXX
SXXXXXXXXXXXXXXXXXXXXXXXXXXXXXXXXXXXXXXXXXXXXXXXXXXXXXXXXXXXXXXXXXXXXXXXXXXXXXXXXXXXXXXXXXXXXXXXXXXXXXXXXXXXXXXXXXXXXXXXXXXXXXXXXXXXXXXXXXXXXXXXXXXXXX
