S----SSSSSSSSSSSSSSSSSSSSSSSSSSSSSSSSSSSSSSSSSSSSSSSSSSSSSSSSSSSSSSSSSSSSSSSSSSSSSSSSSSSSSSSSSSSSSSSSSSSSSSSSSSSSSSSSSSSSSSSSSSSSSSSSSSSSSSSSSSSSSSSSS
S----SSSSSSSSSSSSSSS-----SSSSSSSSSSSSSSSSSSSSSSSSSSSSSSSSSSSSSSSSSSSSSSSSSS-------------SSSSSSSSSSSSSSSSSSSS-------SSSSSSSSSSSSSSSSSSSS---------------
S----SSSSSSS-------------SSSSSSSSSSSS-----SSSSSSSSSSSSSS------------SSSSSSS-------------SSSSSSSSSSSS---------------SSSSSSSSSSSSSSSSSSSS---------------
S------------------------------SSSSSS-----SSSSSSSSSSSSSS--------------------------------SSSSSS-----------------------------SSSSSSSSSSSS---------------
S-----------------------------------------------------------------------------------------------------------------------------------------------------
S-----------------------------------------------------------------------------------------------------------------------------------------------------
S-----------------------------------------------------------------------------------------------------------------------------------------------------
S-----------------------------------------------------------------------------------------------------------------------------------------------------
S------------------------------------------------------ooo----------------------------------------------oooo----------ooS-----------------------------
S----------------------------------------------------------------------oSoSoSoo------------------------------------------------SSSoSo-----------------
S----------------------------------------------------ooooo---oooo--------------------------------------oooooo---------oooooo--------------------------
S---------------oSooo---------------------------------r------------------ooooo---------oSSoSoooo------------------------------------------------------
SXXXXXXXXX------------------ooo-------XXXXX--------XXXXXXXXXXXXXXXX-----y----------------------------XXXXXXXXXXXXXXXXXXXXXXXX-------------ooo---------
SXXXXXXXXXXX--ooooooo--XXXX-----------XXXXXXX----XXXXXXXXXXXXXXXXXX---XXXXXXXXXXX-------oooooooo-----XXXXXXXXXXXXXXXXXXXXXXXXXXXXXXXXX-------------XXX
SXXXXXXXXXXX-----------XXXXXXXXXXXXXXXXXXXXXX----XXXXXXXXXXXXXXXXXXXXXXXXXXXXXXXX-----------Y--r-----XXXXXXXXXXXXXXXXXXXXXXXXXXXXXXXXXXXXXXXXX-----XXX
SXXXXXXXXXXXXXXXXXXXXXXXXXXXXXXXXXXXXXXXXXXXXXXXXXXXXXXXXXXXXXXXXXXXXXXXXXXXXXXXXXXXXXXXXXXXXXXXXXXXXXXXXXXXXXXXXXXXXXXXXXXXXXXXXXXXXXXXXXXXXXXXXXXXXX
