S----SSSSSSSSSSSSSSSSSSSSSSSSSSSSSSSSSSSSSSSSSSSSSSSSSSSSSSSSSSSSSSSSSSSSSSSSSSSSSSSSSSSSSSSSSSSSSSSSSSSSSSSSSSSSSSSSSSSSSSSSSSSSSSSSSSSSSSSSSSSSSSSSS
S-------------------SSSSSSSSSSSSSSSSSSSSSSSSSSSSSSSSSSSSSSSSSSSSSSSSSSSSSS--------SSSSSSSSSSSSSSSSS-----SSSSSSSSSSSSSSSSS-----SSSSSS-------SSSSSSSSSSS
S-------------------SSSSSSSSSSSSSSSSSSSSSSSSSSSSSSSSSSSSSSSSSSSSSSSSSSSSSS--------SSSSSSS---------------SSSSSSSSSSSSSSSSS-----SSSSSS-------SSSSSSS----
S-------------------SSSSSSSSSSSSSSSS------------SSSSSSSSSSSS--------------------------------------------SSSSSSSSSSSS----------SSSSSS-------SSSSSSS----
S-----------------------------------------------------------------------------------------------------------------------------------------------------
S-----------------------------------------------------------------------------------------------------------------------------------------------------
S-----------------------------------------------------------------------------------------------------------------------------------------------------
S-----------------------------------------------------------------------------------------------------------------------------------------------------
S--------------------------------------------------------------------------------------------oooSo----------------------------------------------------
S--------------------------------------------------------------------------------oooo-----------------------------------------------------------------
S-------------SSooo----------------ooS----------------oSSoo----------------------------------oooo------------------------------oo----ooSoSoooo--------
S-------------------------------------------ooooSSoo-----------------oooo----------oooo----------g----------ooSS--------oooSo--g----------------------
SXXXXXXXXX---ooooo------------------oo----------------oo------------------------------------XXXXXXXXXXXX----------------------XXXXXX---ooooooo---ooo--
SXXXXXXXXX--k---------------oooo-----r-----ooooooooo----k-------------oooo------XXXXXXXXX---XXXXXXXXXXXX---ooo----------oooo--XXXXXX---------R--------
SXXXXXXXXXXXXXXXXXXXXXXXXX-rry----XXXXXXXX---r-------XXXXXXX-K------y---y----XXXXXXXXXXXX---XXXXXXXXXXXX----------XXX---------XXXXXXXXXXXXXXXXXXXXXXXX
SXXXXXXXXXXXXXXXXXXXXXXXXXXXXXXXXXXXXXXXXXXXXXXXXXXXXXXXXXXXXXXXXXXXXXXXXXXXXXXXXXXXXXXXXXXXXXXXXXXXXXXXXXXXXXXXXXXXXXXXXXXXXXXXXXXXXXXXXXXXXXXXXXXXXX
