S----SSSSSSSSSSSSSSSSSSSSSSSSSSSSSSSSSSSSSSSSSSSSSSSSSSSSSSSSSSSSSSSSSSSSSSSSSSSSSSSSSSSSSSSSSSSSSSSSSSSSSSSSSSSSSSSSSSSSSSSSSSSSSSSSSSSSSSSSSSSSSSSSS
S----SSSSSSSSSSSSSSSSSSSSSSSSSSSS-----SSSSSSS-------SSSSSSSSSSSS-------SSSSSSSSSSSSSSSSSSSS-------SSSSSSS--------SSSSSSSSSSSSSSSSSSSSSSSSSSSSSSSSSSSSS
S------------SSSSSSSSSSSSSSSSSSSS-----SSSSSSS-------SSSSSSSSSSSS-------SSSSSSSSSSSSSSSSSSSS-------SSSSSSS-------------SSSSSSSSSSSSS-------------------
S------------SSSSSSS-----SSSSSSSS-----SSSSSSS-------SSSSSSSSSSSS----------------------------------SSSSSSS-------------------SSSSSSS-------------------
S-----------------------------------------------------------------------------------------------------------------------------------------------------
S-----------------------------------------------------------------------------------------------------------------------------------------------------
S-----------------------------------------------------------------------------------------------------------------------------------------------------
S-----------------------------------------------------------------------------------------------------------------------------------------------------
S------------------ooSooS---------------------------------------------oooS------------------oSo-------------------------------------------------SooS--
S---------------------------------------------Tt---ooo--------SSS------------------------------------------------------oSSoooo------------------------
S-------------------oooo-----------------tt---Tt-------------------------ooo---------------oooo-------------------------------------------------ooooo-
S--------------------g---y--------oooo---tt---Tt---oo--------ooo-----------------------------------------ooSS-----------oooo-----oooooo---------------
S-----------------XXXXXXXXXX------------XXXXXXXXXX-r---r-----k-g---XXXXXXXXXXXXXXX------XXXXXXXX-----------------------k------------g---------XXXXXXXX
S--------------XXXXXXXXXXXXX----ooooo---XXXXXXXXXXXXXXXXX--XXXXXXXXXXXXXXXXXXXXXXXXXXXXXXXXXXXXXXXXXX--ooooooo---y---XXXXXXXXXXXXXXXXXXX--oo--XXXXXXXX
S---------XXXXXXXXXXXXXXXXXXXXX---------XXXXXXXXXXXXXXXXX--XXXXXXXXXXXXXXXXXXXXXXXXXXXXXXXXXXXXXXXXXX-y--------XXXXXXXXXXXXXXXXXXXXXXXXX----g-XXXXXXXX
SXXXXXXXXXXXXXXXXXXXXXXXXXXXXXXXXXXXXXXXXXXXXXXXXXXXXXXXXXXXXXXXXXXXXXXXXXXXXXXXXXXXXXXXXXXXXXXXXXXXXXXXXXXXXXXXXXXXXXXXXXXXXXXXXXXXXXXXXXXXXXXXXXXXXX
