S----SSSSSSSSSSSSSSSSSSSSSSSSSSSSSSSSSSSSSSSSSSSSSSSSSSSSSSSSSSSSSSSSSSSSSSSSSSSSSSSSSSSSSSSSSSSSSSSSSSSSSSSSSSSSSSSSSSSSSSSSSSSSSSSSSSSSSSSSSSSSSSSSS
S----SSSSSSSSSSSSSSSSSSSSSSSSSSSSSSSSSSSSSSSSSSSSS------SSSSSSSSSSSSS----------SSSSSSSSSSSSSSSSSS-------SSSSS--------SSSSSSSSSSSSSSSSS-----SSSSSSSSSSS
S----SSSSSSSSSSSSSSSS------SSSSSSSSSSSSSSSSSSSSSSS------SSSSS------------------SSSSSSSSSSSSSSSSSS-------SSSSS-------------SSSSSS-----------SSSSSSSSSSS
S----SSSSSSSS-------------------SSSSSSSSSSSSSSSSSS------SSSSS-----------------------------------------------------------------------------------------
S-----------------------------------------------------------------------------------------------------------------------------------------------------
S-----------------------------------------------------------------------------------------------------------------------------------------------------
S-----------------------------------------------------------------------------------------------------------------------------------------------------
S-----------------------------------------------------------------------------------------------------------------------------------------------------
S------------oSoo-------------------------------SSooSoo------oSSSo----------------------oooooS--------------------------------------------------------
S---------------------------------------------------------------------oSooo---------------------------------------------------------------------------
S-----------oo----------------ooS---------------ooooo-----oooooooo-----------------------ooooo----ooo----SoSooo--oSSooo------------------------Sooo---
S---------------r---ooo----------------oooo----------y---------r-----ooooo------------y------k--------------------------------------------------------
S---------XXXXXXXX------------ooooo---------g-XXXXXXXXXXXXXXXXXXXXX------------XXXX--XXXXXXXXXXXXXXXXXX--oooo------oooo-----XXX----oooo-XXX----ooooo--
S---------XXXXXXXXXXXXXXXX----------XXXXXXXXXXXXXXXXXXXXXXXXXXXXXXXXXXXXXXXXX--XXXX--XXXXXXXXXXXXXXXXXX-------------r-------XXXXXX--y---XXX-----y--ky-
S---------XXXXXXXXXXXXXXXXXXXXXXXXXXXXXXXXXXXXXXXXXXXXXXXXXXXXXXXXXXXXXXXXXXXXXXXXX--XXXXXXXXXXXXXXXXXXXXXXXXXXXXXXXXXXX----XXXXXXXXXXXXXXXXXXXXXXXXXX
SXXXXXXXXXXXXXXXXXXXXXXXXXXXXXXXXXXXXXXXXXXXXXXXXXXXXXXXXXXXXXXXXXXXXXXXXXXXXXXXXXXXXXXXXXXXXXXXXXXXXXXXXXXXXXXXXXXXXXXXXXXXXXXXXXXXXXXXXXXXXXXXXXXXXX
