S----SSSSSSSSSSSSSSSSSSSSSSSSSSSSSSSSSSSSSSSSSSSSSSSSSSSSSSSSSSSSSSSSSSSSSSSSSSSSSSSSSSSSSSSSSSSSSSSSSSSSSSSSSSSSSSSSSSSSSSSSSSSSSSSSSSSSSSSSSSSSSSSSS
S----SSSSS-------SSSSSSSSSSSSSSSSSSSSSSSSSSSSS------SSSSSSSSSSSSSSSSSSSSSSSSSSSSSSSSSSSSS--------SSSSSSS-------SSSSSSSSSSSSSSSSSSSSSSSSSSSSSSSSSSSSSSS
S----------------SSSSS-----SSSSSS-----SSSSSSSS------SSSSSSSSSSSSS------SSSSSSSSSSSSSSSSSS--------SSSSSSS-------SSSSSSSSSSSSSSSSSSSSSSSS-----SSSSSSSSSS
S---------------------------------------------------SSSSS-------------------SSSSSSSSSSSSS------------------------------SSSSSSSS-------------------SSSS
S-----------------------------------------------------------------------------------------------------------------------------------------------------
S-----------------------------------------------------------------------------------------------------------------------------------------------------
S-----------------------------------------------------------------------------------------------------------------------------------------------------
S-----------------------------------------------------------------------------------------------------------------------------------------------------
S--------------ooS-------oooo-----------SSoSo----------------------------------------------ooS--------------------------------------------------------
S-----------------------------------------------------------------ooo---------------------------------------------------------------------------------
S-----------ooooooo-------oooo---------oooooooo--------oooo----------------oooo----------oooooo-----------------------------------------------oooo----
S-----------------------g-y---------------g---k-------------y-----oo---------------------------------Soo----------------------------------------g-----
S----------XXXXXXXXXXXXXXXXXXXXXXXXXXXXXXXXXXXXXX----XXXXXXXXX--------g--oooo----------XXXXXXXXXXX------------oooooo---------------------XXXXXXXXXX---
S----------XXXXXXXXXXXXXXXXXXXXXXXXXXXXXXXXXXXXXXXXXXXXXXXXXXXXXXXXXXXXX-k-----r---r---XXXXXXXXXXX---oooooo--k---g-g--XXXXX--------------XXXXXXXXXXXXX
S----------XXXXXXXXXXXXXXXXXXXXXXXXXXXXXXXXXXXXXXXXXXXXXXXXXXXXXXXXXXXXXXXXXXXXXXXXXXXXXXXXXXXXXXX-y--------XXXXXXXXXXXXXXX---XXXXX------XXXXXXXXXXXXX
SXXXXXXXXXXXXXXXXXXXXXXXXXXXXXXXXXXXXXXXXXXXXXXXXXXXXXXXXXXXXXXXXXXXXXXXXXXXXXXXXXXXXXXXXXXXXXXXXXXXXXXXXXXXXXXXXXXXXXXXXXXXXXXXXXXXXXXXXXXXXXXXXXXXXX
