------------------------------------------------------------------------------------------------------------------------------------------------------
------------------------------------------------------------------------------------------------------------------------------------------------------
------------------------------------------------------------------------------------------------------------------------------------------------------
------------------------------------------------------------------------------------------------------------------------------------------------------
------------------------------------------------------------------------------------------------------------------------------------------------------
----------------------------------------------------------------------------------------------------------------------------Yg------------------------
-------------------------------------------------------------------------------------------------------------------------%%%%%%-----------------------
-------------------------------------------------------------------------------------------------------------------------||||||-----------------------
-----------------------------------------k-------------------------------------------------------------------------------||||||-----------------------
----------------------------------------%%%------------------------------------------------------------------------------||||||---------------r-------
-----------------Soo-----SSoS-----------|||----------Sooo----------------tt------------K----------ooooo------------------||||%%%%%%%----------%%%%%---
--------------------------------------r-g||------------------------------tt-tt--------%%%--------------------y-----------|||||||||||----------|||||---
----------------oo------ooooooo-XXX-%%%%%||---------ooo------------------tt-tt--------|||--------oooooooo---%%%----------|||||y|||||----------|||||-k-
-----------------------y--------XXX-|||||||--------------------------XXXXXXXXXXX------||y---y---------------|||---y----XXXXXXXXXXXXXXXX------XXXXXXXXX
XXXXXXXXXXXXXXXXXXXXXXXXXXXXXXXXXXX-||k||||-g-----XXXXXXXXX----------XXXXXXXXXXXXXXXXXXXXXXXXXXXXXXXXXXXXXXXXXXXXXXXXXXXXXXXXXXXXXXXXXXXXXXXXXXXXXXXXX
XXXXXXXXXXXXXXXXXXXXXXXXXXXXXXXXXXXXXXXXXXXXXXXXXXXXXXXXXXXXXXX--XXXXXXXXXXXXXXXXXXXXXXXXXXXXXXXXXXXXXXXXXXXXXXXXXXXXXXXXXXXXXXXXXXXXXXXXXXXXXXXXXXXXX