S----SSSSSSSSSSSSSSSSSSSSSSSSSSSSSSSSSSSSSSSSSSSSSSSSSSSSSSSSSSSSSSSSSSSSSSSSSSSSSSSSSSSSSSSSSSSSSSSSSSSSSSSSSSSSSSSSSSSSSSSSSSSSSSSSSSSSSSSSSSSSSSSSS
S------------SSSSSS------SSSSSSSSSSSSSSS--------SSSSSSSSSSSSSSSSSSSSSSSSSSSSSSSSSS-----SSSSSSSSSSSSSSSSSSSSSSSSSSS------SSSSSSSSSSSSSSSSSSSSSSSSSSSS--
S------------SSSSSS------SSSSSSSS-------------------------------------SSSSSSSSSSSS-----SSSSSSSSSSSSSSSSSSSSSSSSSSS------SSSSS------SSSSSSSSSSSSSSSSS--
S--------------------------------------------------------------------------SSSSSSS------------------SSSSSSSSSSSSSS------SSSSS------SSSSSSSSSSSSSSSSS--
S-----------------------------------------------------------------------------------------------------------------------------------------------------
S-----------------------------------------------------------------------------------------------------------------------------------------------------
S-----------------------------------------------------------------------------------------------------------------------------------------------------
S-----------------------------------------------------------------------------------------------------------------------------------------------------
S-------------------------------------------Soo-------------------------------------------------------------oSSoo-----------------------ooSo----------
S----------------------------------------------------oooS------------------------------------------------------------------------Soo------------------
S------------SSSoo-----------------------ooooooo-----------------------------------------------------------oooooooo-------------------oooooo----------
S--------------------------------------------r-------oooooo--------oooSSoooo--------------------------------g-----------oSo------ooo---yk---------oo--
SXXXXXXXXX---ooooo---XXXX---oo-------XXXXXXXXXXXXX----k----g-XXXXX------------------XXXXXXX----------XXXXXXXXXXXXXXX-----------------XXXXXXXXXX-------
SXXXXXXXXX-----------XXXX------------XXXXXXXXXXXXXXXXXXXXXXXXXXXXX----ooo----XXXXXXXXXXXXXX-ooo------XXXXXXXXXXXXXXX----oooooo-XXXXXXXXXXXXXXXXXXXXXXX
SXXXXXXXXXXXXXXXXXXXXXXXXXXXXXXX-----XXXXXXXXXXXXXXXXXXXXXXXXXXXXX-------gk--XXXXXXXXXXXXXX-y----k-XXXXXXXXXXXXXXXXX-----------XXXXXXXXXXXXXXXXXXXXXXX
SXXXXXXXXXXXXXXXXXXXXXXXXXXXXXXXXXXXXXXXXXXXXXXXXXXXXXXXXXXXXXXXXXXXXXXXXXXXXXXXXXXXXXXXXXXXXXXXXXXXXXXXXXXXXXXXXXXXXXXXXXXXXXXXXXXXXXXXXXXXXXXXXXXXXX
