S----SSSSSSSSSSSSSSSSSSSSSSSSSSSSSSSSSSSSSSSSSSSSSSSSSSSSSSSSSSSSSSSSSSSSSSSSSSSSSSSSSSSSSSSSSSSSSSSSSSSSSSSSSSSSSSSSSSSSSSSSSSSSSSSSSSSSSSSSSSSSSSSSS
S----SSSSSSSSSSSSSSSSSSSSSSSSSSSSSSSSSSSSSSSSSSSSSSSSSSSSS--------SSSSS-------SSSSSSSSSSSSSSSSSSSSSSSSSSSSSSSSSSSSSS--------SSSSSSSSSSSSSSSSS-------SS
S----SSSSSSSSSSSSSSSSSSSS--------SSSSSSSSSSSSSSSSS----------------SSSSS-------SSSSSSS--------SSSSSSSSSSSSSSSS--------------------SSSSSSSSSSSS-------SS
S----SSSSSSSSSSSSSSSSSSSS-------------------SSSSSS----------------SSSSS----------------------SSSSSSSS-------------------------------------------------
S-----------------------------------------------------------------------------------------------------------------------------------------------------
S-----------------------------------------------------------------------------------------------------------------------------------------------------
S-----------------------------------------------------------------------------------------------------------------------------------------------------
S-----------------------------------------------------------------------------------------------------------------------------------------------------
S-------------------------------------oooSo------------------------------------------SooSo------------------------------------------------------------
S---------------------ooSoo--------------------------ooooSSoo-----------------------------------------------------------------------------------------
S--------------------------------------oooo----------------------------------ooSo---------------ooo-------------------------------------oooS----------
S-------------------ooooo----oooo---------------------ooooooo----oo---------------------------------------------ooooo-----ooooo-----------------------
SXXXXXXXXXXXXXXX-------------------XXXXXXXXX-------------------------------oooo----XXXXXXXXXXXX---------XXXX-----------------rg-XXXXXX---oo------XXXXX
SXXXXXXXXXXXXXXX---XXXXXXXXXXXXXXXXXXXXXXXXX--------XXXXXXXXXXXXXXXXX------------k-XXXXXXXXXXXX-------XXXXXXXXXXXXXXXXXXXXXXXXXXXXXXXX---------XXXXXXX
SXXXXXXXXXXXXXXXXXXXXXXXXXXXXXXXXXXXXXXXXXXXXXXXXXXXXXXXXXXXXXXXXXXXX-----XXXXXXXXXXXXXXXXXXXXXXXXXXXXXXXXXXXXXXXXXXXXXXXXXXXXXXXXXXXXXXXXXXXXXXXXXXXX
SXXXXXXXXXXXXXXXXXXXXXXXXXXXXXXXXXXXXXXXXXXXXXXXXXXXXXXXXXXXXXXXXXXXXXXXXXXXXXXXXXXXXXXXXXXXXXXXXXXXXXXXXXXXXXXXXXXXXXXXXXXXXXXXXXXXXXXXXXXXXXXXXXXXXX
