S----SSSSSSSSSSSSSSSSSSSSSSSSSSSSSSSSSSSSSSSSSSSSSSSSSSSSSSSSSSSSSSSSSSSSSSSSSSSSSSSSSSSSSSSSSSSSSSSSSSSSSSSSSSSSSSSSSSSSSSSSSSSSSSSSSSSSSSSSSSSSSSSSS
S----SSSSSSSSSSSSSSSSSSSSSSSSSSSSSSSSSSSSSSSSSSSSSSSSSSSSSSSSSSSSSSSSSSSSSSSSSSSSSSSSSSSSSS-----SSSSSSSSSSSSSSSS--------SSSSSSSSSSSS------------SSSSSS
S-----------SSSSSSSSSSSSSS---------------SSSSSSSSSSSSSSSSSSSSSSSSSSSSSSSSSSSSSSSSSSSSSSSSSS-----SSSSSSSS----------------------SSSSSS------------SSSSSS
S----------------------------------------SSSSSSSSSSSS--------SSSSSSSSSSSS------SSSSS------------SSSSSSSS----------------------SSSSSS------------SSSSSS
S-----------------------------------------------------------------------------------------------------------------------------------------------------
S-----------------------------------------------------------------------------------------------------------------------------------------------------
S-----------------------------------------------------------------------------------------------------------------------------------------------------
S-----------------------------------------------------------------------------------------------------------------------------------------------------
S---------------------------------------------ooSo-------------------------------------ooo--------------------ooSoooo--------------------oooo---------
S-----------------------------------------------------------------oSo--------------------------------------------------------------------------ooooo--
S--------------------------------------------oooooo--oSooS------------------------------oooo--------SSSoo--------oo--------------------ooo------------
S--------------------SoSSSSSo-------------------y--------------oooo------------------------------------------------------ooooSo----------------oooooo-
S------------------------------------------XXXXXXXXX-oooooooo-----------------XXXX--XXXXXXXXX-------ooooooo--XXXXXXXXXX---------XXXXXXXXXXXXXX--------
S-------------------ooooooo----------------XXXXXXXXX----------XXXXXXXXX-oo----XXXXXXXXXXXXXXXXXXXX----k---y--XXXXXXXXXX-ooooo---XXXXXXXXXXXXXXXXXXXXXX
SXXXXXXXXXX-----------------g---------XXXXXXXXXXXXXXXXXXXXXXXXXXXXXXXXX--r-yr-XXXXXXXXXXXXXXXXXXXXXXXXXXXXXXXXXXXXXXXXX----g-k--XXXXXXXXXXXXXXXXXXXXXX
SXXXXXXXXXXXXXXXXXXXXXXXXXXXXXXXXXXXXXXXXXXXXXXXXXXXXXXXXXXXXXXXXXXXXXXXXXXXXXXXXXXXXXXXXXXXXXXXXXXXXXXXXXXXXXXXXXXXXXXXXXXXXXXXXXXXXXXXXXXXXXXXXXXXXX
