S----SSSSSSSSSSSSSSSSSSSSSSSSSSSSSSSSSSSSSSSSSSSSSSSSSSSSSSSSSSSSSSSSSSSSSSSSSSSSSSSSSSSSSSSSSSSSSSSSSSSSSSSSSSSSSSSSSSSSSSSSSSSSSSSSSSSSSSSSSSSSSSSSS
S----SSSSSSSSSSSSSSSSSSSSSSSSSSSSSSSSSSSSSS------------SSSSSSSS--------SSSSSSSSSSSSS----------SSSSSS-------------------SSSSSSSSSSSSSSSSSSS------------
S----SSSSSSSSSSSSSSSSSS--------------SSSSSS------------SSSSSSSS--------SSSSS---------------------------------------------------SSSSS------------------
S---------SSSSSSS--------------------SSSSSS------------SSSSSSSS--------SSSSS---------------------------------------------------SSSSS------------------
S-----------------------------------------------------------------------------------------------------------------------------------------------------
S-----------------------------------------------------------------------------------------------------------------------------------------------------
S-----------------------------------------------------------------------------------------------------------------------------------------------------
S-----------------------------------------------------------------------------------------------------------------------------------------------------
S-----------------------------------------------------------------------------------------------------------------------------------------------------
S---------------------------------------------------------ooo-------------------------ooSooo----------------------------------------------------------
S-----------------------------------------------------------------------oSS------------------------oooo-------------oooo------------------------------
S-----------------------------------y--------------------------------------------------ooooo---------y----oSoooo----------------------------------Soo-
S------------r---XXXXX----------XXXXXXX-------XXXX----------------XXXXX--------XXXXXX--G----------XXXXXXX---------XXXXXXX-----------XXXXX-------------
SXXXXXXXXXXXXXXXXXXXXXXXXXXXXXXXXXXXXXXXXX----XXXX-------XXXXXXXXXXXXXX-----y--XXXXXXXXXXXXXXX----XXXXXXX---ooooo-XXXXXXX-tt-tt-----XXXXXXXXXXX-oo----
SXXXXXXXXXXXXXXXXXXXXXXXXXXXXXXXXXXXXXXXXXXXXXXXXXXX---XXXXXXXXXXXXXXXXXXXXXXXXXXXXXXXXXXXXXXXXXXXXXXXXXX---k-g---XXXXXXX-tt-tt-----XXXXXXXXXXX-------
SXXXXXXXXXXXXXXXXXXXXXXXXXXXXXXXXXXXXXXXXXXXXXXXXXXX---XXXXXXXXXXXXXXXXXXXXXXXXXXXXXXXXXXXXXXXXXXXXXXXXXXXXXXXXXXXXXXXXXXXXXXXXXXXXXXXXXXXXXXXXXXXXXXX
