S----SSSSSSSSSSSSSSSSSSSSSSSSSSSSSSSSSSSSSSSSSSSSSSSSSSSSSSSSSSSSSSSSSSSSSSSSSSSSSSSSSSSSSSSSSSSSSSSSSSSSSSSSSSSSSSSSSSSSSSSSSSSSSSSSSSSSSSSSSSSSSSSSS
S----SSSSSSSSSSSSSSSS-----SSSSSSSS------------SSSSSSSS------SSSSSSSSSSSSSSSSSSSSSSSSSSSSSSSSSS------SSSSSSSSSSSSSSSSSSSSSSSSSSS-------SSSSSSSS-------S
S--------------SSSSSS-----SSSSSSSS----------------------------------SSSSSSSSSSSSSSSSSSS--------------------SSSSSSSSSSSSSSSSSSSS----------------------S
S--------------SSSSSS-----------------------------------------------------SSSSSSSS--------------------------------------------------------------------
S-----------------------------------------------------------------------------------------------------------------------------------------------------
S-----------------------------------------------------------------------------------------------------------------------------------------------------
S-----------------------------------------------------------------------------------------------------------------------------------------------------
S-----------------------------------------------------------------------------------------------------------------------------------------------------
S-----------------------------------------------------------------------------------------------------------------------------------------------------
S-------------ooSoS-------Sooooo-------------------------------------------------------------------------------------------ooSSSoo--------------------
S------------------------------------------------------------oSoS-------------------------ooo---------------------------------------------------------
S---------------ooooo----ooooooo--------------------oSo--------------------oSSS------------------SoS-------------------------oooooo-------------------
S------------------g-----------------------------r------------oooo----------------------XXXXXXX-----------------oo---XXXXX-----------XXXXXX-----------
SXXXXXXXXXXXXXXXXXXXXXXXXXXXXXXXXX---k--XXXXXXXXXXX---oooo------r-k-------ooooo---------XXXXXXX----oo----------g--g--XXXXXXXXXXXXXXXXXXXXXX--y--------
SXXXXXXXXXXXXXXXXXXXXXXXXXXXXXXXXXXXXXXXXXXXXXXXXXX---r----XXXXXXXXX--------g---------k-XXXXXXX-------XXXXXXXXXXXXXXXXXXXXXXXXXXXXXXXXXXXXXXXXXXXXXXXX
SXXXXXXXXXXXXXXXXXXXXXXXXXXXXXXXXXXXXXXXXXXXXXXXXXXXXXXXXXXXXXXXXXXXXXXXXXXXXXXXXXXXXXXXXXXXXXXXXXXXXXXXXXXXXXXXXXXXXXXXXXXXXXXXXXXXXXXXXXXXXXXXXXXXXX
