------------------------------------------------------------------------------------------------------------------------------------------------------
------------------------------------------------------------------------------------------------------------------------------------------------------
------------------------------------------------------------------------------------------------------------------------------------------------------
-------------------------------------------------------------------g-gYG------------------------------------------------------------------------------
----------------------------------------------------------------%%%%%%%%%---------------------G--------------------------------------------------Yy-Gy
----------------------------------------------------------------|||||||||--------------------%%%------------------------------------------------%%%%%%
XXXXXXXXXy-----g----------------------------%%---%%-----------o-|||||||||tt------------------|||--o---------------------------------------------||||||
XXXXXXXXXXXXXXXX-----o----------------------||---||-------------|||||||||tt------------------|||-o-%%%%o----------------------------------------||||||
XXXXXXXXXXXXXXXX--%%%%%---------------------||---||-------------||||tt|||tt-----ooo----------|||---||||-oY----Gy---------o-%%%-----------------o||||||
XXXXXXXXXXXXXXXX--|||||-----o---------------||---||-o--------g--||||tt|||tt--------%%%%%%%XXXXXXXXXXXXXXXXXXXXXXXXX---o----|||oo-o--------------||XXXX
XXXXXXXXXXXXXXXXog|||||---------------------||---||--------XXXXXXXXXXXXXXXX--------|||||||XXXXXXXXXXXXXXXXXXXXXXXXX--------|||------o---------o-|FXXXX
XXXXXXXXXXXXXXXXXXXXXXXX--------------------||---||--------XXXXXXXXXXXXXXXX-tt-----|||||||XXXXXXXXXXXXXXXXXXXXXXXXXtt--tt--|||---------o---tt--XXXXXXX
XXXXXXXXXXXXXXXXXXXXXXXX--------------------||---||--o-----XXXXXXXXXXXXXXXX-tt--XXXXXXXXXXXXXXXXXXXXXXXXXXXXXXXXXXXtt--tt--|||-------g--G--ttG-XXXXXXX
XXXXXXXXXXXXXXXXXXXXXXXX------oXXX--Y-------||---||-----y--XXXXXXXXXXXXXXXX-tt--XXXXXXXXXXXXXXXXXXXXXXXXXXXXXXXXXXXXXXXXXXXXXXXXXXXXXXXXXXXXXXXXXXXXXX
XXXXXXXXXXXXXXXXXXXXXXXXXXXXXXXXXXXXXXXXXXXXXXXXXXXXXXXXXXXXXXXXXXXXXXXXXXXXXXXXXXXXXXXXXXXXXXXXXXXXXXXXXXXXXXXXXXXXXXXXXXXXXXXXXXXXXXXXXXXXXXXXXXXXXX
XXXXXXXXXXXXXXXXXXXXXXXXXXXXXXXXXXXXXXXXXXXXXXXXXXXXXXXXXXXXXXXXXXXXXXXXXXXXXXXXXXXXXXXXXXXXXXXXXXXXXXXXXXXXXXXXXXXXXXXXXXXXXXXXXXXXXXXXXXXXXXXXXXXXXX
