------------------------------------------------------------------------------------------------------------------------------------------------------
------------------------------------------------------------------------------------------------------------------------o-----------------------------
---------------------------------------------------------------------------------o--------------------------------o---------------o-------------------
-----------------------------------------------------------------------------------------------o-------------GG-GG--------o---tt-----------------g--G-
---------------------------------------------------------------------------------------o-----tt---tt-------o%%tt%%%%%%%-----%%tt----o----------%%%%%%%
---------------------------------------------------%%%-----------------------o-ott-----------tt---tt%%------||tt|||||||-----||tt-%%%-----y-----||F||||
---------------------------------------------------|||--------------------tto---tt-G---Y-G-y-tt---tt||%%-G--||ttXXXXXXXXXXXXXXXXXXXXXXXXXXXXXXXXXX||||
-----------------------%%%-------------------------|||--------------------tt--XXXXXXXXXXXXXXXXXXXXXXXXXXXXXXXXXXXXXXXXXXXXXXXXXXXXXXXXXXXXXXXXXXXXXXXX
-----------------------|||-------------------------|||-------%%-----------tt--XXXXXXXXXXXXXXXXXXXXXXXXXXXXXXXXXXXXXXXXXXXXXXXXXXXXXXXXXXXXXXXXXXXXXXXX
----------------o------|||--o-------------tt-------|||---o---||--------Yo-tt--XXXXXXXXXXXXXXXXXXXXXXXXXXXXXXXXXXXXXXXXXXXXXXXXXXXXXXXXXXXXXXXXXXXXXXXX
-------tto-------------|||-------------%%%tt%------|||-------||-------XXXXXXXXXXXXXXXXXXXXXXXXXXXXXXXXXXXXXXXXXXXXXXXXXXXXXXXXXXXXXXXXXXXXXXXXXXXXXXXX
-------tt---y----------|||--------%%%--||XXXXXo----|||-------||--o----XXXXXXXXXXXXXXXXXXXXXXXXXXXXXXXXXXXXXXXXXXXXXXXXXXXXXXXXXXXXXXXXXXXXXXXXXXXXXXXX
-------tt--%%%----%%%%-|||--------|||--||XXXXX-----||tt------||--tt---XXXXXXXXXXXXXXXXXXXXXXXXXXXXXXXXXXXXXXXXXXXXXXXXXXXXXXXXXXXXXXXXXXXXXXXXXXXXXXXX
XXXXXXXXXXXXXXXXXXXXXXXXX|-y------|||-G||XXXXX-----||tt------||--ttY--XXXXXXXXXXXXXXXXXXXXXXXXXXXXXXXXXXXXXXXXXXXXXXXXXXXXXXXXXXXXXXXXXXXXXXXXXXXXXXXX
XXXXXXXXXXXXXXXXXXXXXXXXXXXXXXXXXXXXXXXXXXXXXXXXXXXXXXXXXXXXXXXXXXXXXXXXXXXXXXXXXXXXXXXXXXXXXXXXXXXXXXXXXXXXXXXXXXXXXXXXXXXXXXXXXXXXXXXXXXXXXXXXXXXXXX
XXXXXXXXXXXXXXXXXXXXXXXXXXXXXXXXXXXXXXXXXXXXXXXXXXXXXXXXXXXXXXXXXXXXXXXXXXXXXXXXXXXXXXXXXXXXXXXXXXXXXXXXXXXXXXXXXXXXXXXXXXXXXXXXXXXXXXXXXXXXXXXXXXXXXX
