------------------------------------------------------------------------------------------------------------------------------------------------------
------------------------------------------------------------------------------------------------------------------------------------------------------
------------------------------------------------------------------------------------------------------------------------------------------------------
------------------------------------------------------------------------------------------------------------------------------------------------------
-----------------------------------------------------------------%%--------------------------%%%------------------------------------------------------
---------------o-------------------------------------------------||--------------------------|||------------------------------------------------------
--------tt-------------%%-------------------------------------o--||---------------o----------|||------------------------------------------------G-----
--------tt--------o----||------------------------o---o-----------||------------tttt----------|||--------------y-----g-G--------%%-----------%%%%%%----
--------tt----XXXXXXX--||-----------------------o------o---------||------------tttt----------|||--Y-g--------%%%%%%%%%%%%%-----||-----------||||||-o--
--------tt--Y-XXXXXXX--||------------o-------------o--tt---------||------------tttt------o-o-|||-%%%%%-------|||||||||||||-----||----o------||||||----
XXXXXXXXXXXXXXXXXXXXXXXXXXXX------o------g----tt----g-tt-------o-||---------XXXXXXXX---------|||-|||||--o----||||tt|||tt||-----||-tt-----o--||||||----
XXXXXXXXXXXXXXXXXXXXXXXXXXXX---o---tt---%%%-%%tt%%--XXXXXXXXXXXXX||---------XXXXXXXX---------|||-|||||----o--||||tt|||tt|tt--%%tt-tt%%------|||||F---o
XXXXXXXXXXXXXXXXXXXXXXXXXXXX---tt--tt-XXXXXXXXXXXXXXXXXXXXXXXXXXX||----o----XXXXXXXX---------||tt|||||------tt|||tt|||tt|tto-||tt-tt||--XXXXXXXXXXXXXX
XXXXXXXXXXXXXXXXXXXXXXXXXXXX---tt--tt-XXXXXXXXXXXXXXXXXXXXXXXXXXXXXXXG------XXXXXXXX---------||tt|||||-g---gtt|||tt|||tt|tt--||tt-tt||--XXXXXXXXXXXXXX
XXXXXXXXXXXXXXXXXXXXXXXXXXXXXXXXXXXXXXXXXXXXXXXXXXXXXXXXXXXXXXXXXXXXXXXXXXXXXXXXXXXXXXXXXXXXXXXXXXXXXXXXXXXXXXXXXXXXXXXXXXXXXXXXXXXXXXXXXXXXXXXXXXXXXX
XXXXXXXXXXXXXXXXXXXXXXXXXXXXXXXXXXXXXXXXXXXXXXXXXXXXXXXXXXXXXXXXXXXXXXXXXXXXXXXXXXXXXXXXXXXXXXXXXXXXXXXXXXXXXXXXXXXXXXXXXXXXXXXXXXXXXXXXXXXXXXXXXXXXXX
