---------------------------------------------------------------o----------------------o--o------------------------------------------------------------
------------------------------------------------------------------------------------o-----------------------------------------------------------------
-------------o------------------------------------------------o---------------------------------------------------------------------------------------
--------o-tt---o------------------------------------------o----------------------tt-y---og-------o----------------------------------------------------
---------ott---------------------g-------------------------tt------go-gG---------tt%%%--%%%%%%-----------------------------------o------o-------------
----------tto-------------------%%%%-----------------------tt--XXX%%%%%%%--------tt|XXXXXXXXXXXX------------------------------G-----tt----o---------%%
XXXXXXXXX-tt-------o------------||||--------------------y--tt--XXX||||||tttt-----tt|XXXXXXXXXXXX---tt----------------------%%%%%%%%%tt%-----o-------||
XXXXXXXXXXXXXXXXX-g-------------||||--------------------XXXXXXXXXX||||||tttt----XXXXXXXXXXXXXXXX--ott----------------------|||||||||tt|-------------||
XXXXXXXXXXXXXXXXX%%%----------o-||||---------------G-gg-XXXXXXXXXX||||||tttt----XXXXXXXXXXXXXXXXXXXXXXX-o------------------|||||||||tt|----------F--||
XXXXXXXXXXXXXXXXXXXXXXXXXXXXX---||||-------o------%%%%%%XXXXXXXXXXXXXXX|tttt----XXXXXXXXXXXXXXXXXXXXXXX-------------------o||||XXXXXXXXXXXXXXXXXXXXXXX
XXXXXXXXXXXXXXXXXXXXXXXXXXXXX---||||o--------o----||||||XXXXXXXXXXXXXXXXXXXXXX--XXXXXXXXXXXXXXXXXXXXXXX--------o--%%%%-----||ttXXXXXXXXXXXXXXXXXXXXXXX
XXXXXXXXXXXXXXXXXXXXXXXXXXXXX---|||XX-------------||XXXXXXXXXXXXXXXXXXXXXXXXXXXXXXXXXXXXXXXXXXXXXXXXXXXXXXXXXXX---||||-----||ttXXXXXXXXXXXXXXXXXXXXXXX
XXXXXXXXXXXXXXXXXXXXXXXXXXXXX---|||XX----o------XXXXXXXXXXXXXXXXXXXXXXXXXXXXXXXXXXXXXXXXXXXXXXXXXXXXXXXXXXXXXXX--g||||-----||ttXXXXXXXXXXXXXXXXXXXXXXX
XXXXXXXXXXXXXXXXXXXXXXXXXXXXXXXXXXXXXY----yg----XXXXXXXXXXXXXXXXXXXXXXXXXXXXXXXXXXXXXXXXXXXXXXXXXXXXXXXXXXXXXXXXXXXXXXXXXXXXXXXXXXXXXXXXXXXXXXXXXXXXXX
XXXXXXXXXXXXXXXXXXXXXXXXXXXXXXXXXXXXXXXXXXXXXXXXXXXXXXXXXXXXXXXXXXXXXXXXXXXXXXXXXXXXXXXXXXXXXXXXXXXXXXXXXXXXXXXXXXXXXXXXXXXXXXXXXXXXXXXXXXXXXXXXXXXXXX
XXXXXXXXXXXXXXXXXXXXXXXXXXXXXXXXXXXXXXXXXXXXXXXXXXXXXXXXXXXXXXXXXXXXXXXXXXXXXXXXXXXXXXXXXXXXXXXXXXXXXXXXXXXXXXXXXXXXXXXXXXXXXXXXXXXXXXXXXXXXXXXXXXXXXX
