------------------------------------------------------------------------------------------------------------------------------------------------------
---------------o--o-o-----------------tto----o-----------tt-------------------------------------------------------------------------------------------
--------------------------tt----------tt-----------------tt-------------------------------------------------------------------------------------------
----------o---------------ttG---o-----tt---------Y-------tt-------------------------------------------------------------------------------------------
-------------o------------tt%%---%%-o-tt-------%%%%------tt----o--%%%%--------------------------------------------------------------------------------
-----------------XXXXXXXXXXXXXXXXXXXXXXXXXX-g--||||oy-XXXXX---tt--||||--------------------------------------------------%%----Y--G--------------------
XXXXXXXXXXXXXXXXXXXXXXXXXXXXXXXXXXXXXXXXXXXXXXXXXXXXXXXXXXX---tt--||||--------------------------------------------------||--%%%%%%%%------------------
XXXXXXXXXXXXXXXXXXXXXXXXXXXXXXXXXXXXXXXXXXXXXXXXXXXXXXXXXXX---tt--||||--------------------------------------------------||--||||||||------------------
XXXXXXXXXXXXXXXXXXXXXXXXXXXXXXXXXXXXXXXXXXXXXXXXXXXXXXXXXXX---tt--||||--------------------------------------------------||--||||||||---y-Y------------
XXXXXXXXXXXXXXXXXXXXXXXXXXXXXXXXXXXXXXXXXXXXXXXXXXXXXXXXXXXXXXXX--||||-o------------------------------------------------||--||||||||%%%%%%%-----------
XXXXXXXXXXXXXXXXXXXXXXXXXXXXXXXXXXXXXXXXXXXXXXXXXXXXXXXXXXXXXXXX--||||o---o--------------------------g--o-------%%%-----tt--|||||||||||||||---tto-----
XXXXXXXXXXXXXXXXXXXXXXXXXXXXXXXXXXXXXXXXXXXXXXXXXXXXXXXXXXXXXXXX--||||--o--------tt-----tt----------%%%--------tt||--o-ott--|||||||||||||||---tt------
XXXXXXXXXXXXXXXXXXXXXXXXXXXXXXXXXXXXXXXXXXXXXXXXXXXXXXXXXXXXXXXX--||||--------G--tt---tttt----------|||--------tt||-----tt-o||||||||||||tt|---tttt--tt
XXXXXXXXXXXXXXXXXXXXXXXXXXXXXXXXXXXXXXXXXXXXXXXXXXXXXXXXXXXXXXXXXXXXXXXXXXXXXXXXXtt---tttt----o-----|||------g-tt||G----tt--||||||||||||tt|-G-tttF--tt
XXXXXXXXXXXXXXXXXXXXXXXXXXXXXXXXXXXXXXXXXXXXXXXXXXXXXXXXXXXXXXXXXXXXXXXXXXXXXXXXXXXXXXXXXXXXXXXXXXXXXXXXXXXXXXXXXXXXXXXXXXXXXXXXXXXXXXXXXXXXXXXXXXXXXX
XXXXXXXXXXXXXXXXXXXXXXXXXXXXXXXXXXXXXXXXXXXXXXXXXXXXXXXXXXXXXXXXXXXXXXXXXXXXXXXXXXXXXXXXXXXXXXXXXXXXXXXXXXXXXXXXXXXXXXXXXXXXXXXXXXXXXXXXXXXXXXXXXXXXXX
