------------------------------------------------------------------------------------------------------------------------------------------------------
------------------------------------------------------------------------------------------------------------------------------------------------------
------------------------------------------------------------------------------------------------------------------------------------------------------
------------------------------------------------------------------------------------------------------------------------------------------------------
------o------------gY-y------------------------------------o---------------------------------------------------G--Y----------GY-g-g-------------------
------------------%%%%%%%%-----------------------G---------------------------------------%%----------------%%%%%%%%%%-------%%%%%%%%%-----------------
------------------||||||||----------------------%%%%--------tt---------------------o-----||o---------------||||||||||-------|||||||||-----------------
------------------||||||||----------------------||||--------tt---o-----------------------||---------------tt|||||||||-------|||||||||-----------------
XXXXXXXXX---------||||||||----------------------||||-----XXXXXXXXX---------o-----Y--%%%%-||-G-o-o----G--tttt|||||||||-------|||||||||-----------------
XXXXXXXXX---------||||||||---G------------------||||-%%--XXXXXXXXX-------------oXXXXXXXXXXXXXXXXXXXXXX--tttt|||||||||-------|||||||||---o--------o----
XXXXXXXXXo--------||||||||--%%%%%%%-------------||||-||--XXXXXXXXX--ott---------XXXXXXXXXXXXXXXXXXXXXXg-tttt|||tt||||%%--o--|||||||||--------%%-------
XXXXXXXXX-G----Gg-||||||||--|||||||-------------XXXXXXXXXXXXXXXXXX---tt-g-------XXXXXXXXXXXXXXXXXXXXXXXXXXXXX||tt|||||tt----|||||||||---tt---||-------
XXXXXXXXXXXXXXXXX-||||||||--|||||||-----------ttXXXXXXXXXXXXXXXXXXXXXXXXXXXX----XXXXXXXXXXXXXXXXXXXXXXXXXXXXX||tt|||||tt-y--|||||||||---tt---||-------
XXXXXXXXXXXXXXXXXXXXXXXXXXXXXX|||||Y------o--ottXXXXXXXXXXXXXXXXXXXXXXXXXXXX--XXXXXXXXXXXXXXXXXXXXXXXXXXXXXXX||tt||||XXXXXXX|||||||||-XXtt---||--F-gg-
XXXXXXXXXXXXXXXXXXXXXXXXXXXXXXXXXXXXXXXXXXXXXXXXXXXXXXXXXXXXXXXXXXXXXXXXXXXXXXXXXXXXXXXXXXXXXXXXXXXXXXXXXXXXXXXXXXXXXXXXXXXXXXXXXXXXXXXXXXXXXXXXXXXXXX
XXXXXXXXXXXXXXXXXXXXXXXXXXXXXXXXXXXXXXXXXXXXXXXXXXXXXXXXXXXXXXXXXXXXXXXXXXXXXXXXXXXXXXXXXXXXXXXXXXXXXXXXXXXXXXXXXXXXXXXXXXXXXXXXXXXXXXXXXXXXXXXXXXXXXX
