-------------------------------------------------------------------------------------------------------o---------o------------------------------------
----------------------------------------------------------------------------------------o------------------tt--tt-------------------------------------
-----------------------------------------------------------------------------------------------------------tt--tt-------------------------------------
----------------------------------------------------------------------------------------y---g--ttG--o------tttttt----og-----o-------------------------
-----------------------------------------o--------------------------o-------%%-----g---%%%%%%%-tt%%-%%%----tttttt---%%%tt-----tt-%%%%-----------------
-----------------------------------o--o---------o-------o-------------------||-XXXXXXXXXXXXXXXXXXXXXXXXXXXXXXXXXXXXXXXXtt----ott%||||%%-----tt--tt%---
---------oo--o--%%---------------%%--------o--%%tt--%%%%%-tt----------%tt---tt-XXXXXXXXXXXXXXXXXXXXXXXXXXXXXXXXXXXXXXXXXX---G-tt|||||||o----tt--tF|---
--------------o-||------o--o-----||-------tt--||tt--|||||-tt-------g--|tt---tt-XXXXXXXXXXXXXXXXXXXXXXXXXXXXXXXXXXXXXXXXXXo--XXXXXXXXXXXXXXXXXXXXXXXXXX
---------------o||--------Gg-----||-----YGtt--XXXXXXXXXXXXXXXXXXXXXXXXXXXXXXXXXXXXXXXXXXXXXXXXXXXXXXXXXXXXXXXXXXXXXXXXXXXXXXXXXXXXXXXXXXXXXXXXXXXXXXXX
----------------||------%%%%%%--Y||g---XXXXXXXXXXXXXXXXXXXXXXXXXXXXXXXXXXXXXXXXXXXXXXXXXXXXXXXXXXXXXXXXXXXXXXXXXXXXXXXXXXXXXXXXXXXXXXXXXXXXXXXXXXXXXXX
-------oG--g-G--||-----XXXXXXXXXXXXXXXXXXXXXXXXXXXXXXXXXXXXXXXXXXXXXXXXXXXXXXXXXXXXXXXXXXXXXXXXXXXXXXXXXXXXXXXXXXXXXXXXXXXXXXXXXXXXXXXXXXXXXXXXXXXXXXX
XXXXXXXXXXXXXXXXX|-----XXXXXXXXXXXXXXXXXXXXXXXXXXXXXXXXXXXXXXXXXXXXXXXXXXXXXXXXXXXXXXXXXXXXXXXXXXXXXXXXXXXXXXXXXXXXXXXXXXXXXXXXXXXXXXXXXXXXXXXXXXXXXXX
XXXXXXXXXXXXXXXXX|-tt--XXXXXXXXXXXXXXXXXXXXXXXXXXXXXXXXXXXXXXXXXXXXXXXXXXXXXXXXXXXXXXXXXXXXXXXXXXXXXXXXXXXXXXXXXXXXXXXXXXXXXXXXXXXXXXXXXXXXXXXXXXXXXXX
XXXXXXXXXXXXXXXXX|Ytt--XXXXXXXXXXXXXXXXXXXXXXXXXXXXXXXXXXXXXXXXXXXXXXXXXXXXXXXXXXXXXXXXXXXXXXXXXXXXXXXXXXXXXXXXXXXXXXXXXXXXXXXXXXXXXXXXXXXXXXXXXXXXXXX
XXXXXXXXXXXXXXXXXXXXXXXXXXXXXXXXXXXXXXXXXXXXXXXXXXXXXXXXXXXXXXXXXXXXXXXXXXXXXXXXXXXXXXXXXXXXXXXXXXXXXXXXXXXXXXXXXXXXXXXXXXXXXXXXXXXXXXXXXXXXXXXXXXXXXX
XXXXXXXXXXXXXXXXXXXXXXXXXXXXXXXXXXXXXXXXXXXXXXXXXXXXXXXXXXXXXXXXXXXXXXXXXXXXXXXXXXXXXXXXXXXXXXXXXXXXXXXXXXXXXXXXXXXXXXXXXXXXXXXXXXXXXXXXXXXXXXXXXXXXXX
