------------------------------------------------------------------------------------------------------------------------------------------------------
------------------------------------------------------------------------------------------------------------------------------------------------------
-------------------------------------------------------------------------------------------------o----------------------------------------------------
--------------------------------------------------o---o---------------------------------------------gg-------------g-------------tt-------------------
--------------------------------tt-------o------tt---tt--o-------------------------------%%--------%%%%---------o-%%%-%%---------tt%%--------%%%%-----
-------------------g---Yo-------tt-----o---o-o--tt-o-tt----------------------------------||--------||||--o--------|||-||---------tt||--------||||-----
-----------------tt%%-%%%tt-----tt-%%%tt---tt---tt---ttG------y----G---------------------||--------||||%%------G--|||-||---------tt||--------||||-----
-------o--g------tt||G|||tt-g-o-tt-|||tt-g-tt---tt---tt%%%%--%%%%%%%%--------------------||-XXXXXXXXXXXXXXXXXXXXXXX||tt|tt------XXXXXX-------||||-----
XXXXXXXXXXXXXXXXXXXXXXXXXXXXXXXXXXXXXXXXXXXXXXXXXXXXXXXXXX|--||||||||-----g--------------||-XXXXXXXXXXXXXXXXXXXXXXX||tt|tt------XXXXXX-------||||-%%%-
XXXXXXXXXXXXXXXXXXXXXXXXXXXXXXXXXXXXXXXXXXXXXXXXXXXXXXXXXX|--||||||||---o%%%--o----------||-XXXXXXXXXXXXXXXXXXXXXXX||tt|tt-oG---XXXXXX------tt|||-|||-
XXXXXXXXXXXXXXXXXXXXXXXXXXXXXXXXXXXXXXXXXXXXXXXXXXXXXXXXXX|--||||||||----|||-------------||-XXXXXXXXXXXXXXXXXXXXXXXXXXXXXXXXXX--XXXXXX------tt|||F|||-
XXXXXXXXXXXXXXXXXXXXXXXXXXXXXXXXXXXXXXXXXXXXXXXXXXXXXXXXXX|--||||||||----|||-----XXXXXXXXXXXXXXXXXXXXXXXXXXXXXXXXXXXXXXXXXXXXXXXXXXXXXXXXXXXXXXXXXXXXX
XXXXXXXXXXXXXXXXXXXXXXXXXXXXXXXXXXXXXXXXXXXXXXXXXXXXXXXXXXXXXXXX|||||----|||-----XXXXXXXXXXXXXXXXXXXXXXXXXXXXXXXXXXXXXXXXXXXXXXXXXXXXXXXXXXXXXXXXXXXXX
XXXXXXXXXXXXXXXXXXXXXXXXXXXXXXXXXXXXXXXXXXXXXXXXXXXXXXXXXXXXXXXX|||||Y---XX|-----XXXXXXXXXXXXXXXXXXXXXXXXXXXXXXXXXXXXXXXXXXXXXXXXXXXXXXXXXXXXXXXXXXXXX
XXXXXXXXXXXXXXXXXXXXXXXXXXXXXXXXXXXXXXXXXXXXXXXXXXXXXXXXXXXXXXXXXXXXXXXXXXXXXXXXXXXXXXXXXXXXXXXXXXXXXXXXXXXXXXXXXXXXXXXXXXXXXXXXXXXXXXXXXXXXXXXXXXXXXX
XXXXXXXXXXXXXXXXXXXXXXXXXXXXXXXXXXXXXXXXXXXXXXXXXXXXXXXXXXXXXXXXXXXXXXXXXXXXXXXXXXXXXXXXXXXXXXXXXXXXXXXXXXXXXXXXXXXXXXXXXXXXXXXXXXXXXXXXXXXXXXXXXXXXXX
