------------------------------------------------------------------------------------------------------------------------------------------------------
------------------------------------------------------------------------------------------------------------------------------------------------------
------------------------------------------------------------------------------------------------------------------------------------------------------
------------------------------------------------------------------------------------------------------------------------------------------------------
--------------------------------------o--o------------------------------%%---g----%%%%----------------------------------------------------------------
-------------%%%------------------o-----%%%-----------------------------||-%%%%---||||----------------------------------------------------tt---%%%%---
-------------|||------------------------|||-----------------------------||-||||---||||-----------------------Y-Yy----G-y--G--------oYY-ttGtt---tt||---
-------------|||--------------o-----o---|tt-----------------------------||-||||---||||----------------------%%%%%%--%%%%%%%%%%%%%%%%%%%tt%tt---ttF|---
-------------|||---y----------------XXXX|tt--------yYG------------------||-||||---||||----------------------||||||--||||||||||||ttXXXXXXXXXXXXXXXXXXXX
-----------tt|||--%%%-o---------XXXXXXXXXXXX-----%%%%%%--g-g-----g-yG---||-||||---||||--o---o---------------||||||--||||||||||||ttXXXXXXXXXXXXXXXXXXXX
-----------tt|||--|||-----------XXXXXXXXXXXX-tto-||||||%%%%%%%%%%tt%%%--||-|||tt-tt|||----------------------||||||--||tt||||||||ttXXXXXXXXXXXXXXXXXXXX
-----------tt|||--|||------o-G--XXXXXXXXXXXX-tt--||||||||||tt||||tt|||--||-|||tt-tt|||------------o-o-o-----||||||XXXXtt|||||XXXXXXXXXXXXXXXXXXXXXXXXX
XXXXXXXXXXXXXXXXXXXXXXXXXXXXXXXXXXXXXXXXXXXX-tt--||||||||||tt||||tt|||--|tt|||tt-tt|||-tt---%tt-tt-g--------||||||XXXXtt|||||XXXXXXXXXXXXXXXXXXXXXXXXX
XXXXXXXXXXXXXXXXXXXXXXXXXXXXXXXXXXXXXXXXXXXXXXXXXXXXXXXXX||tt||||tt|||--|tt|||tt-tt|||Gtt-g-|tt%tt%%%-----Go||||||XXXXtt|||||XXXXXXXXXXXXXXXXXXXXXXXXX
XXXXXXXXXXXXXXXXXXXXXXXXXXXXXXXXXXXXXXXXXXXXXXXXXXXXXXXXXXXXXXXXXXXXXXXXXXXXXXXXXXXXXXXXXXXXXXXXXXXXXXXXXXXXXXXXXXXXXXXXXXXXXXXXXXXXXXXXXXXXXXXXXXXXXX
XXXXXXXXXXXXXXXXXXXXXXXXXXXXXXXXXXXXXXXXXXXXXXXXXXXXXXXXXXXXXXXXXXXXXXXXXXXXXXXXXXXXXXXXXXXXXXXXXXXXXXXXXXXXXXXXXXXXXXXXXXXXXXXXXXXXXXXXXXXXXXXXXXXXXX
