------------------------------o-----------------------------------------------------------------------------------------------------------------------
--------------------------------o-----------------------------------------o---------------------------------------------------------------------------
------------------------tt-----o-----------------------------------tt---------------------------------------------------------------------------------
----------------------tttt-----------------------------------------tt-----------g---g-----------------------------------------------------------------
----------------------tttt%%---%%%%----------tt------------tt--%%%%tt----------%%%%%%%------yYYG------------------------------------------------------
------------G-----XXXXXXXXXXXXXXXXXX---------tt-----o------tt--||||tt---%%-----XX|||||-----%%%%%%-------------------------------%%--------------------
-----tt----XXXXXXXXXXXXXXXXXXXXXXXXX---------tt------------tt--XXXXXXXXXXXX----XX||tttt----||||||--------y---------oo-----------||-------o------------
-----tt----XXXXXXXXXXXXXXXXXXXXXXXXX-------Y-tt------G-----tt-GXXXXXXXXXXXXXXXXXX||ttttG---||||||---%%-%%%%%-------------------tt|o--tt------------G--
-----tt----XXXXXXXXXXXXXXXXXXXXXXXXX-----XXXXXXXXXXXXXXXXXXXXXXXXXXXXXXXXXXXXXXXXXXXXXXX-ott|||||--tt|-|||||-------------%%----tt|---tt------------XXX
XXXXXXXXXXXXXXXXXXXXXXXXXXXXXXXXXXXXXXXXXXXXXXXXXXXXXXXXXXXXXXXXXXXXXXXXXXXXXXXXXXXXXXXX--tt|||||--tt|-|||||-------------||-tt-tt|---tt------------XXX
XXXXXXXXXXXXXXXXXXXXXXXXXXXXXXXXXXXXXXXXXXXXXXXXXXXXXXXXXXXXXXXXXXXXXXXXXXXXXXXXXXXXXXXXo-tt|||||o-tt|-|||||-gG-G--------||-tt-tt|g%%tt---o------F-XXX
XXXXXXXXXXXXXXXXXXXXXXXXXXXXXXXXXXXXXXXXXXXXXXXXXXXXXXXXXXXXXXXXXXXXXXXXXXXXXXXXXXXXXXXXXXXXXXXXXXXXXXXXXXXXXXXXXXXXXXXXXXXXXXXXXXXXXXXXXXXXXXo--XXXXX
XXXXXXXXXXXXXXXXXXXXXXXXXXXXXXXXXXXXXXXXXXXXXXXXXXXXXXXXXXXXXXXXXXXXXXXXXXXXXXXXXXXXXXXXXXXXXXXXXXXXXXXXXXXXXXXXXXXXXXXXXXXXXXXXXXXXXXXXXXXXXXXXXXXXXX
XXXXXXXXXXXXXXXXXXXXXXXXXXXXXXXXXXXXXXXXXXXXXXXXXXXXXXXXXXXXXXXXXXXXXXXXXXXXXXXXXXXXXXXXXXXXXXXXXXXXXXXXXXXXXXXXXXXXXXXXXXXXXXXXXXXXXXXXXXXXXXXXXXXXXX
XXXXXXXXXXXXXXXXXXXXXXXXXXXXXXXXXXXXXXXXXXXXXXXXXXXXXXXXXXXXXXXXXXXXXXXXXXXXXXXXXXXXXXXXXXXXXXXXXXXXXXXXXXXXXXXXXXXXXXXXXXXXXXXXXXXXXXXXXXXXXXXXXXXXXX
XXXXXXXXXXXXXXXXXXXXXXXXXXXXXXXXXXXXXXXXXXXXXXXXXXXXXXXXXXXXXXXXXXXXXXXXXXXXXXXXXXXXXXXXXXXXXXXXXXXXXXXXXXXXXXXXXXXXXXXXXXXXXXXXXXXXXXXXXXXXXXXXXXXXXX
