------------------------------------------------------------------------------------------------------------------------------------------------------
------------------------------------------------------------------------------------------------------------------------------------------------------
------------------------------------------------------------------------------------------------------------------------------------------------------
------------------------------------------------------G-----------------------------------------------------------------------------------------------
----------------------------------------------------%%%%%---------------------------------------------------------------------------------------------
----------------------------------------------------|||||----------------------------------------------------------------%%%--------------------------
----------------------------------------------------|||||--------------------------------%%--------------------------o-o-|||--------------------------
----------------------------------------------------|||||--------------------------------||--o------------o--o-----tt-o--|||-------------o------------
----------------%%%o--------------------------------|||||--------------------------------||-------------tt-------o-tt-g--|||--o-----------------------
------tt--------|||--------------o---------o--------|||||--------------o-----------------||-------------tt--o-----%tt%%%-|||-----tt-------------------
------tt--------|||---------------------------------|||||------------------yG------------||--g-y------tttt-tt----XXXXXXXXXXXXXXXXtt-------------------
------tt---g----|||---g-------o---------------------|||||--------------tt%%%%%--oXXXXXXXXXXXXXXXXXXXX-tttt-tt----XXXXXXXXXXXXXXXXtt-o--------G---F--y-
XXXXXXXXXXXXXXXXXXXXXXXX------tt-----tt-------------||tt|--g-----tt----tt|||||-o-XXXXXXXXXXXXXXXXXXXXXXXXXXXXXXXXXXXXXXXXXXXXXXXXXXXXXXXXXXXXXXXXX%%%%
XXXXXXXXXXXXXXXXXXXXXXXX---o--tto-%%%tt-----GY------||tt|-XXX-o-ott----tt|||||---XXXXXXXXXXXXXXXXXXXXXXXXXXXXXXXXXXXXXXXXXXXXXXXXXXXXXXXXXXXXXXXXX||||
XXXXXXXXXXXXXXXXXXXXXXXXXXXXXXXXXXXXXXXXXXXXXXXXXXXXXXXXXXXXXXXXXXXXXXXXXXXXXXXXXXXXXXXXXXXXXXXXXXXXXXXXXXXXXXXXXXXXXXXXXXXXXXXXXXXXXXXXXXXXXXXXXXXXXX
XXXXXXXXXXXXXXXXXXXXXXXXXXXXXXXXXXXXXXXXXXXXXXXXXXXXXXXXXXXXXXXXXXXXXXXXXXXXXXXXXXXXXXXXXXXXXXXXXXXXXXXXXXXXXXXXXXXXXXXXXXXXXXXXXXXXXXXXXXXXXXXXXXXXXX
