----------------------------------------------------------------------------------------------------------------------------------------o-------------
----------------------------------------------------------------------------------------------------------------------------------------------o--o----
-------------------------------------------------------------------------------------------------------------------------------------------tt---------
------------------------------------------------------------------------------------------------------------------------------------o------tt---------
----------------------------------------------------------------------------------------------------------------------------------------%%%tt----F----
-----------------------------------------------------------------------------------------------------------------------------o------XXXXXXXXXXXXXXXXXX
----------------------tt--o-------------------------------------------Y--G-gg------------------------------------------------------%XXXXXXXXXXXXXXXXXX
---------tt----o---%%%tt-----------------------o----------------%%%%%%%%%%%%%%%--------------%%------------------------------------|XXXXXXXXXXXXXXXXXX
---------tt--------|||ttG---------------------------------------|||||||||||||||--------------||------%%---------------------XXXXXXXXXXXXXXXXXXXXXXXXXX
------y--tt------XXXXXXXXX-Go-----------------------------------|||||||||||||||-----o--------||------||----------------g---GXXXXXXXXXXXXXXXXXXXXXXXXXX
XXXXXXXXXXXXXXXXXXXXXXXXXXXX-o--------------------tt------------|||||||||||||||--------------||------||----%%---%%%%%%%%%%%%XXXXXXXXXXXXXXXXXXXXXXXXXX
XXXXXXXXXXXXXXXXXXXXXXXXXXXX--------------------G-tt----tt------||XXXtt||||||||-----tttt-----||------||---o||---|||tt|||||||XXXXXXXXXXXXXXXXXXXXXXXXXX
XXXXXXXXXXXXXXXXXXXXXXXXXXXXtt--tt---%%%XXXXXXXXXXXXX---tt-----o||XXXtt|||||tt|-----tttt--tto||-o----||----||-tttt|tt|XXXXXXXXXXXXXXXXXXXXXXXXXXXXXXXX
XXXXXXXXXXXXXXXXXXXXXXXXXXXXtt--tt---|||XXXXXXXXXXXXXXXXXXXXXXXXXXXXXtt|||||tt|-----tttt-Ytt-||-g-g--||--y-||otttt|tt|XXXXXXXXXXXXXXXXXXXXXXXXXXXXXXXX
XXXXXXXXXXXXXXXXXXXXXXXXXXXXXXXXXXXXXXXXXXXXXXXXXXXXXXXXXXXXXXXXXXXXXXXXXXXXXXXXXXXXXXXXXXXXXXXXXXXXXXXXXXXXXXXXXXXXXXXXXXXXXXXXXXXXXXXXXXXXXXXXXXXXXX
XXXXXXXXXXXXXXXXXXXXXXXXXXXXXXXXXXXXXXXXXXXXXXXXXXXXXXXXXXXXXXXXXXXXXXXXXXXXXXXXXXXXXXXXXXXXXXXXXXXXXXXXXXXXXXXXXXXXXXXXXXXXXXXXXXXXXXXXXXXXXXXXXXXXXX
