--------------------o---------------------------------------------------------------------------------------------------------------------------------
------------------------------------------------------------------------------------------------------------------------------------------tt----o-----
--------------------tt--------------------------------------------------------------------------------tt---o------------------------------tt--tt------
------------gtt-----tt--g---g--------------------------------------------------------------------gg---tt---y-Y-G-g--------------tt-tt-----tt--tt------
-----------%%tt%---%tt%%%%%%%%---------------------------------------------------------------%%%tt%%--tt-%%%%%%%%%%-------------tt-tt%%---tt%%tt-Fo---
------G-Y--||tt|---XXXXXXXXXXX---------------------------%%-------------------------tt-------|||tt||--tt-||||||||||---oo--------ttXXXXXXXXXXX|ttXXXXXX
XXXXXXXXXXXXXXXXXXXXXXXXXXXXXX----y-tt-------------------||-------------------------ttyo-oXXXXXXXXXXXXXXXXXX|||||||------%%-----ttXXXXXXXXXXXXXXXXXXXX
XXXXXXXXXXXXXXXXXXXXXXXXXXXXXX--%tt%tt--Y----------------||----g--y-tt--tt--------XXXXXXXXXXXXXXXXXXXXXXXXXX|||||||tt----||XXXXXXXXXXXXXXXXXXXXXXXXXXX
XXXXXXXXXXXXXXXXXXXXXXXXXXXXXXG-|tt|tt-%%%%%-------------||-%%%%%%%%tt--tt--%%----XXXXXXXXXXXXXXXXXXXXXXXXXX|||||||tt--%%||XXXXXXXXXXXXXXXXXXXXXXXXXXX
XXXXXXXXXXXXXXXXXXXXXXXXXXXXXXXXXXXXXXtt||||-------------||-||||||||tt--tt--||----XXXXXXXXXXXXXXXXXXXXXXXXXX|||||||tt--||||XXXXXXXXXXXXXXXXXXXXXXXXXXX
XXXXXXXXXXXXXXXXXXXXXXXXXXXXXXXXXXXXXXtt||||tt------o----||G||||||||tt--tt-G||----XXXXXXXXXXXXXXXXXXXXXXXXXXXXXXXXXXXXXXXXXXXXXXXXXXXXXXXXXXXXXXXXXXXX
XXXXXXXXXXXXXXXXXXXXXXXXXXXXXXXXXXXXXXXXXXX|tt-----------|XXXXXXXXXXXXXXXXXXXXXXXXXXXXXXXXXXXXXXXXXXXXXXXXXXXXXXXXXXXXXXXXXXXXXXXXXXXXXXXXXXXXXXXXXXXX
XXXXXXXXXXXXXXXXXXXXXXXXXXXXXXXXXXXXXXXXXXX|tt---tt----G-|XXXXXXXXXXXXXXXXXXXXXXXXXXXXXXXXXXXXXXXXXXXXXXXXXXXXXXXXXXXXXXXXXXXXXXXXXXXXXXXXXXXXXXXXXXXX
XXXXXXXXXXXXXXXXXXXXXXXXXXXXXXXXXXXXXXXXXXX|tt---tt---%%%|XXXXXXXXXXXXXXXXXXXXXXXXXXXXXXXXXXXXXXXXXXXXXXXXXXXXXXXXXXXXXXXXXXXXXXXXXXXXXXXXXXXXXXXXXXXX
XXXXXXXXXXXXXXXXXXXXXXXXXXXXXXXXXXXXXXXXXXXXXXXXXXXXXXXXXXXXXXXXXXXXXXXXXXXXXXXXXXXXXXXXXXXXXXXXXXXXXXXXXXXXXXXXXXXXXXXXXXXXXXXXXXXXXXXXXXXXXXXXXXXXXX
XXXXXXXXXXXXXXXXXXXXXXXXXXXXXXXXXXXXXXXXXXXXXXXXXXXXXXXXXXXXXXXXXXXXXXXXXXXXXXXXXXXXXXXXXXXXXXXXXXXXXXXXXXXXXXXXXXXXXXXXXXXXXXXXXXXXXXXXXXXXXXXXXXXXXX
