------------------------------------------------------------------------------------------------------------------------------------------------------
------------------------------------------------------------------------------------------------------------------------------------------------------
------------------------------------------------------------------------------------------------------------------------------------------------------
------------------------------------------------------------------------------------------------------------------------------------------------------
---------------------------------------------------------------y----------------------o---------------------------------------------------------------
-----------------------------------------------------------%%%%%%-------------o--o-------------------------------------Y------------------------------
-------------------------tt-------Gg-G------------o--------||||||--------------------------tt-----------------%%%%%%%%%%%-----------------------------
----------------------%%%tt%%%---%%%%%%%%%-o---------------||||||----------------------o---tt-----------------|||||||||||-----------------------------
----------------------|||tt|||---|||||||||-----------------||||||---tt--tt-------------Y--%ttg----------------|||||||||||-----------------------------
-----------------Y----|||tt|||---|||||||||-----%%%%%---%%--||||||---tt-gttG-----G-XXXXXXXXXXXX-----------o----|||||||||||------o---Go--y----------o---
XXXXXXXXXXXXXXXXXXXXXXXXXXXXXXXXXXXXX|||||-----|||||G--||--||||||-XXXXXXXXXXXXXXXXXXXXXXXXXXXX--------tt------|tttt||||||-------o%%%%%%%%%-------F----
XXXXXXXXXXXXXXXXXXXXXXXXXXXXXXXXXXXXX|||||--XXXXXXXXXXX||--||||||-XXXXXXXXXXXXXXXXXXXXXXXXXXXX--------tt-tt---|tttt||||||--------|||||||||---XXXXXXXXX
XXXXXXXXXXXXXXXXXXXXXXXXXXXXXXXXXXXXXXXXXXXXXXXXXXXXXXXXXXXXXXXX|-XXXXXXXXXXXXXXXXXXXXXXXXXXXX--------ttGtt-tt|tttt||||||-Yg-G---|||||||||---XXXXXXXXX
XXXXXXXXXXXXXXXXXXXXXXXXXXXXXXXXXXXXXXXXXXXXXXXXXXXXXXXXXXXXXXXX|-XXXXXXXXXXXXXXXXXXXXXXXXXXXXXXXXXXXXXXXttott|tttt||||||-XXXXXXXXXXXXXXX|--GXXXXXXXXX
XXXXXXXXXXXXXXXXXXXXXXXXXXXXXXXXXXXXXXXXXXXXXXXXXXXXXXXXXXXXXXXXXXXXXXXXXXXXXXXXXXXXXXXXXXXXXXXXXXXXXXXXXXXXXXXXXXXXXXXXXXXXXXXXXXXXXXXXXXXXXXXXXXXXXX
XXXXXXXXXXXXXXXXXXXXXXXXXXXXXXXXXXXXXXXXXXXXXXXXXXXXXXXXXXXXXXXXXXXXXXXXXXXXXXXXXXXXXXXXXXXXXXXXXXXXXXXXXXXXXXXXXXXXXXXXXXXXXXXXXXXXXXXXXXXXXXXXXXXXXX
