------------------------------------------------------------------------------------------------------------------------------------------------------
------------------------------------------------------------------------------------------------------------------------------------------------------
---------------------------------------tt-tt-o--------------------------------------------------------------------------------------------------------
---------------------------------------tt-tt-----------o----------------------------------------------------------------------------------------------
---------------------------------------tt-tt---------------o------------------------------------------------------------------------------------------
--------------------o------oo-----o-XXXXXXXXXXXXXX------%%----------YGgG----------------------------------------------------------g--Y----------------
-----------------------------------oXXXXXXXXXXXXXX------||---------%%%%%%--G--%%%%--%%-------------------------------------------%%%%%%%%-------------
-----tttt--------%%%%---------o-----XXXXXXXXXXXXXX-yo---||-----%%--||||||o%%%%||||--||-------------------------------------------||||||||o------------
-----tttt-------Y||||-------------G-XXXXXXXXXXXXXXXXXXXXXXXXXXXX|--||||||-||||||||--||-------------------------------o-----------||||||||-------------
-----tttt---XXXXXXXXXXXXXXXXXXXXXXXXXXXXXXXXXXXXXXXXXXXXXXXXXXXX|--||||||-||||||||--||----o----------------------------------o---||||||||-------------
XXXXXXXXXXXXXXXXXXXXXXXXXXXXXXXXXXXXXXXXXXXXXXXXXXXXXXXXXXXXXXXX|g-||||||-||||||||--||-------------o-------------------oo---GY---||||||||--------F----
XXXXXXXXXXXXXXXXXXXXXXXXXXXXXXXXXXXXXXXXXXXXXXXXXXXXXXXXXXXXXXXXXXXXXXXXXXXXXXXXXXXXX|--------------o--------tt---tt----Go%%%%%%%||||||||----XXXXXXXXX
XXXXXXXXXXXXXXXXXXXXXXXXXXXXXXXXXXXXXXXXXXXXXXXXXXXXXXXXXXXXXXXXXXXXXXXXXXXXXXXXXXXXX|-----o-----------------tt---tt-XXXXXXXXXXXXXXXXXXXXXXXXXXXXXXXXX
XXXXXXXXXXXXXXXXXXXXXXXXXXXXXXXXXXXXXXXXXXXXXXXXXXXXXXXXXXXXXXXXXXXXXXXXXXXXXXXXXXXXX|-o---Y---o--o-------G--tt---tt-XXXXXXXXXXXXXXXXXXXXXXXXXXXXXXXXX
XXXXXXXXXXXXXXXXXXXXXXXXXXXXXXXXXXXXXXXXXXXXXXXXXXXXXXXXXXXXXXXXXXXXXXXXXXXXXXXXXXXXXXXXXXXXXXXXXXXXXXXXXXXXXXXXXXXXXXXXXXXXXXXXXXXXXXXXXXXXXXXXXXXXXX
XXXXXXXXXXXXXXXXXXXXXXXXXXXXXXXXXXXXXXXXXXXXXXXXXXXXXXXXXXXXXXXXXXXXXXXXXXXXXXXXXXXXXXXXXXXXXXXXXXXXXXXXXXXXXXXXXXXXXXXXXXXXXXXXXXXXXXXXXXXXXXXXXXXXXX
