------------------------------------------------------------------------------------------------------------------------------------------------------
------------------------------------------------------------------------------------------------------------------------------------------------------
-------------------------------------------------------------------------------------------------------------------------------o----------------------
------------------------------------------------------------------------------------------------------------------------------tt--o-------------------
-------------------------------------------------------------------------------------------%%%--------------------------------tt--------%%%%-------%%%
-------------------------------------------------------------------------------------------|||--------------------------------tt------XXXXXXX------|||
----------------------o--------------------------------------------------------------------|||--------------------------------tt------XXXXXXX----o-|||
----------------tt----tt-----o----------------------o--------------------------------------|||------------------%%%%---------XXXXXXXXXXXXXXXX----F-|||
-------o-------ott----tt------------------o-------%%%----tt--o--------tt------Y------------|||------------------|tt|o--------XXXXXXXXXXXXXXXX--Y-XXXXX
--------tt------tt----tttt-------------o----------|||----tt---------o-tt-----%%%-----------|||--------------%%%%|tt|-%%------XXXXXXXXXXXXXXXXXXXXXXXXX
--------tt----G-tt----tttt-------y----Y-------G-%%|||----tt-----tt----tt%%---|||-------%%--|||o----o-----%%-|||||tt|y||-----gXXXXXXXXXXXXXXXXXXXXXXXXX
XXXXXXXXXXXXXXXXXXXXXXXXXXXXXXXXXXXXXXXXXXXXXXXXXX|||----tt-----tt--gGtt||---|||---tt--||--|||-------tt--|tt||||XXXXXXXXXXXXXXXXXXXXXXXXXXXXXXXXXXXXXX
XXXXXXXXXXXXXXXXXXXXXXXXXXXXXXXXXXXXXXXXXXXXXXXXXXXXXXXXXXXXXXXXXXXXXXXXXXX--|||---tt--||--|||-%%%%%-tt--|tt||||XXXXXXXXXXXXXXXXXXXXXXXXXXXXXXXXXXXXXX
XXXXXXXXXXXXXXXXXXXXXXXXXXXXXXXXXXXXXXXXXXXXXXXXXXXXXXXXXXXXXXXXXXXXXXXXXXX-g|||g--tt--||--|||-|||||-tt--|tt||||XXXXXXXXXXXXXXXXXXXXXXXXXXXXXXXXXXXXXX
XXXXXXXXXXXXXXXXXXXXXXXXXXXXXXXXXXXXXXXXXXXXXXXXXXXXXXXXXXXXXXXXXXXXXXXXXXXXXXXXXXXXXXXXXXXXXXXXXXXXXXXXXXXXXXXXXXXXXXXXXXXXXXXXXXXXXXXXXXXXXXXXXXXXXX
XXXXXXXXXXXXXXXXXXXXXXXXXXXXXXXXXXXXXXXXXXXXXXXXXXXXXXXXXXXXXXXXXXXXXXXXXXXXXXXXXXXXXXXXXXXXXXXXXXXXXXXXXXXXXXXXXXXXXXXXXXXXXXXXXXXXXXXXXXXXXXXXXXXXXX
