------------------------------------------------------------------------------------------------------------------------------------------------------
------------------------------------------------------------------------------------------------------------------------------------------------------
-------------------------------------------------------------------------------------------------------tto--------------------------------------------
---------------------------------------------------------------------------------------------G-gY-Y----tt-------o-----G-------------------------------
-----------------------------------------------------------------------------------------%%%%%%%%%%%%--tt------------%%%------------------------------
-----------------------------------------------------------------------------------------||||||||||||G-tt------------|||-gy---------------------------
--------------------------------------o---------------------------------%%---------------|||||||||||XXXXXXXXXXXXXX--tt||%%%%%--o--tto----o--o---------
-----------------------------------o---o--------------------------------||---------------||||tt|||||XXXXXXXXXXXXXX--tt|||||||---tttt------o--tt%%-----
------------------------------------------------------------------------||-----o-----gY--||||tt|||||XXXXXXXXXXXXXX--tt|||||||-Y-ttttg--------tt||-----
-----------------%%---------------------XXo-----------------------------||%%-----XXXXXXXXXXXXXX|||||XXXXXXXXXXXXXXy-ttXXXXXXXXXXXXXXXXXX-----tt||-tto-
-----------------||o---tt-----oo-gXXXXXXXX-----------------Yy--o----tt--||||-----XXXXXXXXXXXXXXXXXXXXXXXXXXXXXXXXXXXXXXXXXXXXXXXXXXXXXXX---gGtt||Ftt--
-----tt-o--------||-%%-tt--tt---%%XXXXXXXXy--tt-----------%%%%%-----tt--||||-----XXXXXXXXXXXXXXXXXXXXXXXXXXXXXXXXXXXXXXXXXXXXXXXXXXXXXXXXXXXXXXXXXXXXX
-----tt------tt--||tt|-tt--tt---||XXXXXXXXXX-tt---tt------|||ttXXXXXXXXXXXXXXX---XXXXXXXXXXXXXXXXXXXXXXXXXXXXXXXXXXXXXXXXXXXXXXXXXXXXXXXXXXXXXXXXXXXXX
XXXXXXXXXXXXXtt--||tt|-tty-tt---||XXXXXXXXXX%tt%%-tt-g---g|||ttXXXXXXXXXXXXXXXXXXXXXXXXXXXXXXXXXXXXXXXXXXXXXXXXXXXXXXXXXXXXXXXXXXXXXXXXXXXXXXXXXXXXXXX
XXXXXXXXXXXXXXXXXXXXXXXXXXXXXXXXXXXXXXXXXXXXXXXXXXXXXXXXXXXXXXXXXXXXXXXXXXXXXXXXXXXXXXXXXXXXXXXXXXXXXXXXXXXXXXXXXXXXXXXXXXXXXXXXXXXXXXXXXXXXXXXXXXXXXX
XXXXXXXXXXXXXXXXXXXXXXXXXXXXXXXXXXXXXXXXXXXXXXXXXXXXXXXXXXXXXXXXXXXXXXXXXXXXXXXXXXXXXXXXXXXXXXXXXXXXXXXXXXXXXXXXXXXXXXXXXXXXXXXXXXXXXXXXXXXXXXXXXXXXXX
