------------------------------------------------------------------------------------------------------------------------------------------------------
------------------------------------------------------------------------------------------------------------------------------------------------------
------------------------------------------------------------------------------------------------------------------------------------------------------
---------------------------------------------------------------------------------------y----------------------GY--------------------------------------
------------------------------------------------------------------------------------%%%%%%-------------------%%%%-------------------------------------
----------------------------------------------------%%%-----------------------------||||||-------------------||||-------------------------------------
----------------------------------------------------|||-----------------------------||||||-------------------||||-------------------------------------
---------------------------------------------%%-----|||-----------------------------||||||----o--%%%%--------||||-------------------------------------
---------------------------------------------||-----|||----------------o---------o--tt||||-------||||--------||||-------------------------g-----------
---------------------------go-g-----o--------||-----|||------------o---------tt-----tt||||-------||||--------||||--gG-Y------------------%%%%---------
---------------------o----%%%%%%%--o---------||-----|||------tt---o----------tt-----tt||tt-------||||%%-o----||||%%%%%%%%%-----tt--------|||tt----o---
-------------------o------|||||||---------o--||-%%--|||------tt-----------G--tt---o-tt||tt---XX--||||||------|||||tt||||||--o--tt----tt--|||tt--tt--o-
----------------tt-Gg-----|||||||-tt---------tt-||--|||--o---tt-------XXXXXXXXXXXXXXXXXXXXXXXXXXXX|||||--%%%%|||||tt||||||-----tt----tto-tt|tt--tt----
---------G---g--tt%%%%%%%%|||||||ytt---g-gY-Ytt-||--|||----y-tt-G-----XXXXXXXXXXXXXXXXXXXXXXXXXXXXXXXXXXXXXXXXXXXXXXXXXXXX-----tt----ttG-tt|tt--tF----
XXXXXXXXXXXXXXXXXXXXXXXXXXXXXXXXXXXXXXXXXXXXXXXXXXXXXXXXXXXXXXXXXXXXXXXXXXXXXXXXXXXXXXXXXXXXXXXXXXXXXXXXXXXXXXXXXXXXXXXXXXXXXXXXXXXXXXXXXXXXXXXXXXXXXX
XXXXXXXXXXXXXXXXXXXXXXXXXXXXXXXXXXXXXXXXXXXXXXXXXXXXXXXXXXXXXXXXXXXXXXXXXXXXXXXXXXXXXXXXXXXXXXXXXXXXXXXXXXXXXXXXXXXXXXXXXXXXXXXXXXXXXXXXXXXXXXXXXXXXXX
