------------------------------------------------------------------------------------------------------------------------------------------------------
---------------------------------------------------ttoo--------o--------------------------------------------------------------------------------------
-------------------------------o-----o-------o-----tt----o--------------------------------------------------------------------------------------------
-----------------------------------o--------Gtt----tt---o--------------YY-------------------o-----o---------------------------------------------------
---------------------------------tt--%%%%%%%%tt%%%-tt-%%%----Y--%%-G%%%%%%----%%%-----o--o-------------------------------------------------g----------
-------------------------o-Y-----tt--||||||||tt|XXXXXXXXXXXXXXXXXXXXXX||||----|||--------------------------tt---------------------------%%%%%---------
---------------------------XXXXXXXXXXXXXXXXXXXXXXXXXXXXXXXXXXXXXXXXXXX||||----|||-------------%%-----------tt%%-------------------------|||||---------
------------------G--------XXXXXXXXXXXXXXXXXXXXXXXXXXXXXXXXXXXXXXXXXXXXXXXX---|||---Gg--------||%%%%G------tt||--------------------g----|||||---------
------o---------%%%%-------XXXXXXXXXXXXXXXXXXXXXXXXXXXXXXXXXXXXXXXXXXXXXXXX-G-|||---XXXXXXXXXXXXXXXXXXXX-o-tt||-----g-----o-------%%%%--|||||---------
----------------||ttg------XXXXXXXXXXXXXXXXXXXXXXXXXXXXXXXXXXXXXXXXXXXXXXXXXXXXX|o--XXXXXXXXXXXXXXXXXXXXXXXXXXXXXXXXXXX-----------||||o-|||||---------
--------o-------||ttXXXXXXXXXXXXXXXXXXXXXXXXXXXXXXXXXXXXXXXXXXXXXXXXXXXXXXXXXXXX|---XXXXXXXXXXXXXXXXXXXXXXXXXXXXXXXXXXX--tt-o-----||||--|||||-o-------
------------Go--||ttXXXXXXXXXXXXXXXXXXXXXXXXXXXXXXXXXXXXXXXXXXXXXXXXXXXXXXXXXXXX|---XXXXXXXXXXXXXXXXXXXXXXXXXXXXXXXXXXX--tt-------||||--||||tt---tt--o
XXXXXXXXXXXXXXXXXXXXXXXXXXXXXXXXXXXXXXXXXXXXXXXXXXXXXXXXXXXXXXXXXXXXXXXXXXXXXXXXXXXXXXXXXXXXXXXXXXXXXXXXXXXXXXXXXXXXXXX--tt--o----||XXX-||||tttt-tt-XX
XXXXXXXXXXXXXXXXXXXXXXXXXXXXXXXXXXXXXXXXXXXXXXXXXXXXXXXXXXXXXXXXXXXXXXXXXXXXXXXXXXXXXXXXXXXXXXXXXXXXXXXXXXXXXXXXXXXXXXXXXXXXXXXXXXXXXXX-||||tttt-Ft-XX
XXXXXXXXXXXXXXXXXXXXXXXXXXXXXXXXXXXXXXXXXXXXXXXXXXXXXXXXXXXXXXXXXXXXXXXXXXXXXXXXXXXXXXXXXXXXXXXXXXXXXXXXXXXXXXXXXXXXXXXXXXXXXXXXXXXXXXXXXXXXXXXXXXXXXX
XXXXXXXXXXXXXXXXXXXXXXXXXXXXXXXXXXXXXXXXXXXXXXXXXXXXXXXXXXXXXXXXXXXXXXXXXXXXXXXXXXXXXXXXXXXXXXXXXXXXXXXXXXXXXXXXXXXXXXXXXXXXXXXXXXXXXXXXXXXXXXXXXXXXXX
