------------------------------------------------------------------------------------------------------------------------------------------------------
------------------------------------------------------------------------------------------------------------------------------------------------------
------------------------------------------------------------------------------------------------------------------------------------------------------
---------------------------------------------------------------------------------------------------------------------------------------------------o--
----------------------------------------------------%%%%----------------------------------------------------------------------------------Gtt----o----
-----------%%%---------------------------%%%%%---o--||||---------------------------------------------------------------------------------%%tt%%-------
---------o-|||-----------------------%%%%|||||o%%%--||||---------------------------------------------------------------------------------||tt||%%%----
-----------|||-------------------o---|||||||||-|||--||||-------------------------------------------------------------------------o-----g-||tt||||F----
-----------|||----o------------------|||||||||-|||--||||------------------------------o----------------------------------------tt----XXXXXXXXXXXXXXXXX
-----------|||---tt---------o--------|||||||||-|||--||||-------------------------------------g---------------o----G--o---------tt----XXXXXXXXXXXXXXXXX
-----------|||tt-tt-------o----------|||||XXXXXXXXXXXX||--tt--tt--------------------------%%%%%%%-----------tt--%%%%------yY---tt----XXXXXXXXXXXXXXXXX
XXXXXXXXXXXXXXtt%tt%-----tt----------|||||XXXXXXXXXXXX||o-tt--tt----tt---------------tt---||||||tt----------tt-o||||--o-%%%%%%-tt-G--XXXXXXXXXXXXXXXXX
XXXXXXXXXXXXXXXXXXXXXX-g-tt-XXXXXX---|||||XXXXXXXXXXXX||--tt--tt-o--tto--tt--o-tt---%tt-G-||||||tt------o---tt--||||---o|||||XXXXXXXXXXXXXXXXXXXXXXXXX
XXXXXXXXXXXXXXXXXXXXXXXXXXXXXXXXXXy--|||||XXXXXXXXXXXXXXXXXXXXtt----tt-g-tt---%tt-XXXXXXXX||||||tt----XXXXXXXXXXXXX|-G--|||||XXXXXXXXXXXXXXXXXXXXXXXXX
XXXXXXXXXXXXXXXXXXXXXXXXXXXXXXXXXXXXXXXXXXXXXXXXXXXXXXXXXXXXXXXXXXXXXXXXXXXXXXXXXXXXXXXXXXXXXXXXXXXXXXXXXXXXXXXXXXXXXXXXXXXXXXXXXXXXXXXXXXXXXXXXXXXXXX
XXXXXXXXXXXXXXXXXXXXXXXXXXXXXXXXXXXXXXXXXXXXXXXXXXXXXXXXXXXXXXXXXXXXXXXXXXXXXXXXXXXXXXXXXXXXXXXXXXXXXXXXXXXXXXXXXXXXXXXXXXXXXXXXXXXXXXXXXXXXXXXXXXXXXX
