------------------------------------------------------------------------------------------------------------------------------------------------------
------------------------------------------------------------------------------------------------------------------------------------------------------
------------------------------------------------------------------------------------------------------------------------------------------------------
------------------------------------------------------------------------------------------------------------------------------------------------------
----------------------------------------------Y-------------------------------------------------------------------------------------------------------
-------------------------------------------%%%%%----------------------------------Y-----------------------------%%%%%---------------------------------
-------------------------------------------|||||---------------------------------%%%----------------------------|||||o--------------------------------
-------------------------------------------|||||---------------------------------|||----------------------------|||||---------------------------------
-------------------------------------------|||||---------------------%%----------|||----------------------------|||||---------------------------------
---------------o---o-----------------------|||||-----o-o-----------o-||----------|||----------------------------|||||---------------------------------
------------tt-tt------tt------------------|||||--------%%------tt---||---o-----tt||-------------tt-------------|XXXXXXXXX-tt--o------G---------o-----
------------tt-tt------tt---------tt----o--|||||--------||------tt---||---------tt||----------%%%tt-------------|XXXXXXXXX-tt----%%%%%%%%%%%%%--------
XXXXXXXX---ott-tt------tt---------tt-------|||||--------||------tttt-||---------tt||----------|||tt----------tt-|XXXXXXXXX-tttttt|||||||||||||--------
XXXXXXXX----tt-tt------ttY--oo-G--ttG------|||||--------||----G-tttt-||--%%%%%--tt||g-Y---o---|||tto---------tt-|XXXXXXXXX-tttttt|||||||||||||---F---o
XXXXXXXXXXXXXXXXXXXXXXXXXXXXXXXXXXXXXXXXXXXXXXXXXXXXXXXXXXXXXXXXXXXXXXXXXXXXXXXXXXXXXXXXXXXXXXXXXXXXXXXXXXXXXXXXXXXXXXXXXXXXXXXXXXXXXXXXXXXXXXXXXXXXXX
XXXXXXXXXXXXXXXXXXXXXXXXXXXXXXXXXXXXXXXXXXXXXXXXXXXXXXXXXXXXXXXXXXXXXXXXXXXXXXXXXXXXXXXXXXXXXXXXXXXXXXXXXXXXXXXXXXXXXXXXXXXXXXXXXXXXXXXXXXXXXXXXXXXXXX
