------------o------o----------------------------------------------------------------------------------------------------------------------------------
-------------tt--o------------------------------------------------------------------------------------------------------------------------------------
-------------tt---------------------------------------------------------------------------------------------------------------------------------------
----------o--tt-o------------------------------------------------------------o---o--------------------------o--------------------------gYg-Ggy--------
------------%tt%g------o--------------------------------------------------%%---------------g--G----------------tt--g-Y----------------%%%%%%%%%%o----o
----------XXXXXXXXXXtt----tt----------------------------------------------||ott---------ott%%%%%----o----------tt-%%%%%%--------------||||||||||------
----------XXXXXXXXXXtt----tt----------------------------------------------||-tt---tt-----tt|||||------o--------tt-||||||--------------||||||||||tt----
----------XXXXXXXXXXtt----tt--------------------------------------o-------||-tt---tt-----tt|||||--o-------g---ott-||tt||--------------||||||||||tF----
XXXXXXXXXXXXXXXXXXXXXXXXXXtt------------------------------%%%-----------XXXXXXXXXXXXXXXXXXXXXXXXXXXXXXXXXXXXXXXXXXX|tttt-----------o--XXXXXXXXXXXXXXXX
XXXXXXXXXXXXXXXXXXXXXXXXXXXX-------------------------o----|||-----------XXXXXXXXXXXXXXXXXXXXXXXXXXXXXXXXXXXXXXXXXXX|tttt--------------XXXXXXXXXXXXXXXX
XXXXXXXXXXXXXXXXXXXXXXXXXXXX------tt-----oo------------tt-|||---------XXXXXXXXXXXXXXXXXXXXXXXXXXXXXXXXXXXXXXXXXXXXX|tttt-----o--------XXXXXXXXXXXXXXXX
XXXXXXXXXXXXXXXXXXXXXXXXXXXX------tt---o----G-Y--------tt-|||-------o-XXXXXXXXXXXXXXXXXXXXXXXXXXXXXXXXXXXXXXXXXXXXXXXXXXXXXXXXXXXXXXXXXXXXXXXXXXXXXXXX
XXXXXXXXXXXXXXXXXXXXXXXXXXXX------tt--g-XXXXXXX--------tt-|||--%%XXXXXXXXXXXXXXXXXXXXXXXXXXXXXXXXXXXXXXXXXXXXXXXXXXXXXXXXXXXXXXXXXXXXXXXXXXXXXXXXXXXXX
XXXXXXXXXXXXXXXXXXXXXXXXXXXXXXXXXXXXXXXXXXXXXXXXXXXX---tt-|||--||XXXXXXXXXXXXXXXXXXXXXXXXXXXXXXXXXXXXXXXXXXXXXXXXXXXXXXXXXXXXXXXXXXXXXXXXXXXXXXXXXXXXX
XXXXXXXXXXXXXXXXXXXXXXXXXXXXXXXXXXXXXXXXXXXXXXXXXXXXXXXXXXXXXXXXXXXXXXXXXXXXXXXXXXXXXXXXXXXXXXXXXXXXXXXXXXXXXXXXXXXXXXXXXXXXXXXXXXXXXXXXXXXXXXXXXXXXXX
XXXXXXXXXXXXXXXXXXXXXXXXXXXXXXXXXXXXXXXXXXXXXXXXXXXXXXXXXXXXXXXXXXXXXXXXXXXXXXXXXXXXXXXXXXXXXXXXXXXXXXXXXXXXXXXXXXXXXXXXXXXXXXXXXXXXXXXXXXXXXXXXXXXXXX
