-------------o---------------------------------o------------------------------------------------------------------------------------------------------
------------------------------o-------------------------------------------------------------------------------------------------------------o---------
---------tt--------------------------------------------------------------------------------------------------------------------------------------o---o
---------tt--------------tt----o-----------o----------o-------------------------------------------------------------------------------------Yo--Y-----
---------tt-----g---o---gtt%-------tt---%%%%%%%----tt-%tttt----------------------------------------------------------------------G-o-G-----%%%%%%F----
XXXXXXXXXXXXXXXXXXXXXXXXXXXXXXX-%%%tt-XXXXXXXXXXXXXtt-|tttt---------o---------------------------G--g-----Gg----------------------XXXXX-----XXXXXXXXXXX
XXXXXXXXXXXXXXXXXXXXXXXXXXXXXXX-|||tt-XXXXXXXXXXXXXtt-|tttt-------tt------------------------tt-%%%%%%%%%%%%%%----------------%%%-XXXXX-----XXXXXXXXXXX
XXXXXXXXXXXXXXXXXXXXXXXXXXXXXXXXXXXXXXXXXXXXXXXXXXXtto|tttt----G--tt------------------------tt-||tt||||||||tt--tt-tt-o----XXXXXXXXXXXX-----XXXXXXXXXXX
XXXXXXXXXXXXXXXXXXXXXXXXXXXXXXXXXXXXXXXXXXXXXXXXXXXXXXXXXXXXXXXXXXXXX---%%%-----------------tt-||tt||||||||tt--tt-tt---tt-XXXXXXXXXXXX-----XXXXXXXXXXX
XXXXXXXXXXXXXXXXXXXXXXXXXXXXXXXXXXXXXXXXXXXXXXXXXXXXXXXXXXXXXXXXXXXXX-G-|||-------------%%%%tt-||tt||||||||tt--ttottg--tt-XXXXXXXXXXXXXXXXXXXXXXXXXXXX
XXXXXXXXXXXXXXXXXXXXXXXXXXXXXXXXXXXXXXXXXXXXXXXXXXXXXXXXXXXXXXXXXXXXXXXXXX|-o-----------|||XXXXXXXXXXXXXXXXXXXXXXXXXXXXXXXXXXXXXXXXXXXXXXXXXXXXXXXXXXX
XXXXXXXXXXXXXXXXXXXXXXXXXXXXXXXXXXXXXXXXXXXXXXXXXXXXXXXXXXXXXXXXXXXXXXXXXX|--g---Y------|||XXXXXXXXXXXXXXXXXXXXXXXXXXXXXXXXXXXXXXXXXXXXXXXXXXXXXXXXXXX
XXXXXXXXXXXXXXXXXXXXXXXXXXXXXXXXXXXXXXXXXXXXXXXXXXXXXXXXXXXXXXXXXXXXXXXXXXXXXXXXXXXXXXXXXXXXXXXXXXXXXXXXXXXXXXXXXXXXXXXXXXXXXXXXXXXXXXXXXXXXXXXXXXXXXX
XXXXXXXXXXXXXXXXXXXXXXXXXXXXXXXXXXXXXXXXXXXXXXXXXXXXXXXXXXXXXXXXXXXXXXXXXXXXXXXXXXXXXXXXXXXXXXXXXXXXXXXXXXXXXXXXXXXXXXXXXXXXXXXXXXXXXXXXXXXXXXXXXXXXXX
XXXXXXXXXXXXXXXXXXXXXXXXXXXXXXXXXXXXXXXXXXXXXXXXXXXXXXXXXXXXXXXXXXXXXXXXXXXXXXXXXXXXXXXXXXXXXXXXXXXXXXXXXXXXXXXXXXXXXXXXXXXXXXXXXXXXXXXXXXXXXXXXXXXXXX
XXXXXXXXXXXXXXXXXXXXXXXXXXXXXXXXXXXXXXXXXXXXXXXXXXXXXXXXXXXXXXXXXXXXXXXXXXXXXXXXXXXXXXXXXXXXXXXXXXXXXXXXXXXXXXXXXXXXXXXXXXXXXXXXXXXXXXXXXXXXXXXXXXXXXX
