------------------------------------------------------------------------------------------------------------------------------------------------------
------------------------------------------------------------------------------------------------------------------------------------------------------
------------------------------------------------------------------------------------------------------------------------------------------------------
------------------------------------------------------------------------------------------------------------------------------------------------------
-------------------g-----------------------%%%%%---------------------------Y------%%----------------g------------------------------------%%%----------
---------------%%%%%%----------------------|||||---------------------g---%%%%-----||--------------%%%%%--------------------o-------------|||----------
---------------||||||----------------------|||||--------------------%%%%%||||-----||--------------|||||-------------------------%%--o----|||----------
---------------||||||----------------------|||||--------------------|||||||||-----||--------------|||||---------------------o---tt-------|||----------
-------------o-||||||---o------------------|||||-------------------o|||||||||--o--||--------------|||||-------------------tt----tt----tt-|||----------
------------o-tt|||||--o-------------------|||||--------------------|||||||||-----||--------------|||||-------%%---Y-----ott----tt-%%%tt-|||------o---
--------------tt|||||---tt--------------o--|||||-----o--------------|||||||||-----||--------tt----|||||-------||o%%%%%XXXXXXXXXXXXXXXXXXXX||--o--o----
----------tt--tt||||tt--tt%%%%%%%o---------|||||----------o---o-----|||||||||-----||--------tt---o|||||-------||-|XXXXXXXXXXXXXXXXXXXXXXXX||----------
---------gtt--tt||||tt-Gtt|||tt||-----o----||tt|----------------%%%%|||||||||---o-||g---g---tt-o--|||||-------||Y|XXXXXXXXXXXXXXXXXXXXXXXX||----------
XXXXXXXXXXXXXXXXXXXXXXXXXXX||tt||-------g-G||tt|---o-----------XXXXXXXXXXXXXXXXXXXXXXXXXXXXXXXXXXXXXXXXXXXXXXXXXXXXXXXXXXXXXXXXXXXXXXXXXXXXXX--y-F---G
XXXXXXXXXXXXXXXXXXXXXXXXXXXXXXXXXXXXXXXXXXXXXXXXXXXXXXXXXXXXXXXXXXXXXXXXXXXXXXXXXXXXXXXXXXXXXXXXXXXXXXXXXXXXXXXXXXXXXXXXXXXXXXXXXXXXXXXXXXXXXXXXXXXXXX
XXXXXXXXXXXXXXXXXXXXXXXXXXXXXXXXXXXXXXXXXXXXXXXXXXXXXXXXXXXXXXXXXXXXXXXXXXXXXXXXXXXXXXXXXXXXXXXXXXXXXXXXXXXXXXXXXXXXXXXXXXXXXXXXXXXXXXXXXXXXXXXXXXXXXX
