------------------------------------------------------------------------------------------------------------------------------------------------------
----------------------------------------------------------------------------------------------------------------------tt-------o----------------------
----------------------------------------------------------------------------------o-----------------------------------tt------------------------------
------------------------------------------------------------------------------------------------G-tt------------------ttg--------tttt-----------------
-------------------------------------------o------------o---------------------------%%---------%%%tttt-tt-----tt---%%-tttt%%%%%--tttt---------tt------
----------------------------o------------------------tt-----------------------------||%%tt-----|||ttttott-----tt--oXXXXXtt|||||--tttt---------ttg-o---
--------------------------%%%--o--------------o------tt--------------------------%%-||||tt---o-|||tttt-tt-%%--tt---XXXXXXXXXXXXXXXXXX---o---%%tt%%%%--
--------------o-----------|||----------G-------------tt-------o------%%%%%%%----XXXXXXXXXXXXXXXXXXXXXXXXXXXXX-tt---XXXXXXXXXXXXXXXXXX-Y----G||tt|F||--
---------------%%%%%---G--|||----y--%%%%%%o------o---tt--%%--------oG|||||||----XXXXXXXXXXXXXXXXXXXXXXXXXXXXXXXXXXXXXXXXXXXXXXXXXXXXXXXXXXXXXXXXXXXXXX
---------G-----|||XXXXXXXXXXXXXXXXXXXXXXXXXXXXXXXXXXXXXXX||------XXXXXXXXXXXXXXXXXXXXXXXXXXXXXXXXXXXXXXXXXXXXXXXXXXXXXXXXXXXXXXXXXXXXXXXXXXXXXXXXXXXXX
XXXXXXXXXXX----|||XXXXXXXXXXXXXXXXXXXXXXXXXXXXXXXXXXXXXXX||tt--g-XXXXXXXXXXXXXXXXXXXXXXXXXXXXXXXXXXXXXXXXXXXXXXXXXXXXXXXXXXXXXXXXXXXXXXXXXXXXXXXXXXXXX
XXXXXXXXXXX----|||XXXXXXXXXXXXXXXXXXXXXXXXXXXXXXXXXXXXXXX||ttXXXXXXXXXXXXXXXXXXXXXXXXXXXXXXXXXXXXXXXXXXXXXXXXXXXXXXXXXXXXXXXXXXXXXXXXXXXXXXXXXXXXXXXXX
XXXXXXXXXXXXXXXXXXXXXXXXXXXXXXXXXXXXXXXXXXXXXXXXXXXXXXXXXXXXXXXXXXXXXXXXXXXXXXXXXXXXXXXXXXXXXXXXXXXXXXXXXXXXXXXXXXXXXXXXXXXXXXXXXXXXXXXXXXXXXXXXXXXXXX
XXXXXXXXXXXXXXXXXXXXXXXXXXXXXXXXXXXXXXXXXXXXXXXXXXXXXXXXXXXXXXXXXXXXXXXXXXXXXXXXXXXXXXXXXXXXXXXXXXXXXXXXXXXXXXXXXXXXXXXXXXXXXXXXXXXXXXXXXXXXXXXXXXXXXX
XXXXXXXXXXXXXXXXXXXXXXXXXXXXXXXXXXXXXXXXXXXXXXXXXXXXXXXXXXXXXXXXXXXXXXXXXXXXXXXXXXXXXXXXXXXXXXXXXXXXXXXXXXXXXXXXXXXXXXXXXXXXXXXXXXXXXXXXXXXXXXXXXXXXXX
XXXXXXXXXXXXXXXXXXXXXXXXXXXXXXXXXXXXXXXXXXXXXXXXXXXXXXXXXXXXXXXXXXXXXXXXXXXXXXXXXXXXXXXXXXXXXXXXXXXXXXXXXXXXXXXXXXXXXXXXXXXXXXXXXXXXXXXXXXXXXXXXXXXXXX
