------------------------------------------------------------------------------------------------------------------------------------------------------
------------------------------------------------------------------------------------------------------------------------------------------------------
------------------------------------------------------------------------------------------------------------------------------------------------------
----------------------------------------------------------------------------------------------------------------------------y-------------------------
-----------------------------------------------------------------------------------GgG-----------------------------------%%%%%%%%---------------------
----------------------------------------------------G-----------------------------%%%%%----------------------------------||||||||--%%%----------------
--------------------------------------%%%%%%%%%----%%%----------------------------|||||----------------------------------||||||||--|||----------------
------------------------------o-------|||||||||----|||----------------------------|||||-----------------------------%%%--||||||||--|||----------------
--------------------------------------|||||||||----|||----g-----------------------|||||-----------------%%----------|||--||||||||--|||----------------
--------------------------------------|||||||||tt--|||--%%%%%-------g-------------|||||---------------o-||----------|||--||||||||--|||---%%-------tt--
--------------------%%%%%--------o----|||||||||tt--|||--|||||------%%%%-----------|||||------------tt---||----------|||--||||||||--|||---||-----g-tt-o
--------------------|||||--o--XX------|||||||||tt--|tt--|||||------||||-----------|||||-----tt%%---tto-tt|----------|||--||||||||--|||---||---o%%%tt--
--------------------|tt||-----XX------|||||||||tt--|tt--|||||---tt-tt||----o--%%o-|||tt-----tt||--ott--tt|-o---XXXXXXXXXXXXXXXXXXXg|||---||G---||Ftt--
--------G--Y----%%--|tt||-----XX---g--||XXXXXXXXXXXXXXXXXXXXXX-gttGtt||o------||--|||tt-----tt||-o-ttG-tt|G-y--XXXXXXXXXXXXXXXXXXXXXXXXXXXXXXXXXXXXXXX
XXXXXXXXXXXXXXXXXXXXXXXXXXXXXXXXXXXXXXXXXXXXXXXXXXXXXXXXXXXXXXXXXXXXXXXXXXXXXXXXXXXXXXXXXXXXXXXXXXXXXXXXXXXXXXXXXXXXXXXXXXXXXXXXXXXXXXXXXXXXXXXXXXXXXX
XXXXXXXXXXXXXXXXXXXXXXXXXXXXXXXXXXXXXXXXXXXXXXXXXXXXXXXXXXXXXXXXXXXXXXXXXXXXXXXXXXXXXXXXXXXXXXXXXXXXXXXXXXXXXXXXXXXXXXXXXXXXXXXXXXXXXXXXXXXXXXXXXXXXXX
