------------------------------------------------------------------------------------------------------------------------------------------------------
------------------------------------------------------------------------------------------------------------------------------------------------------
--------------------tt-----------o--tt------------------------------------------------------------------------------------------------------o---------
--------------------tt--o----tt-----tt--------------------------------------------------------------------------------------------------------------tt
--------------------tt%%%-y--tt-----tt--tt-----------------------------------------------------------%%%--%%%------------------------------%%-%%----tt
------------o--XXXXXtt|||%%%%tt%----tt--tt-----%%%%--------------------------------------------------|||--|||--%%--------------------------||-||-FXXXX
----------tt-XXXXXXXXXXXXXXXXXXXXXXXXXXXXXXXX-tt|||tt------------------------------------------------|||--|||--||-------------------o-----XXXXXXXXXXXX
----------tt-XXXXXXXXXXXXXXXXXXXXXXXXXXXXXXXX-tt|||tt------------------------------------------------|||-tt||--||----oo------------------gXXXXXXXXXXXX
------o---tt-XXXXXXXXXXXXXXXXXXXXXXXXXXXXXXXXgtt|||tt------------------------------------------------|||-tt||--||--------%tt-%%---------XXXXXXXXXXXXXX
----------ttGXXXXXXXXXXXXXXXXXXXXXXXXXXXXXXXXXXXXXXXXXXXXXXXXX------------------------tt-----o---o---|||-tt||--||-tt-----|tto||--%%-----XXXXXXXXXXXXXX
XXXXXXXXXXXXXXXXXXXXXXXXXXXXXXXXXXXXXXXXXXXXXXXXXXXXXXXXXXXXXX------------------------tt-------------|XXXXXXXXX||-tt%%%%-|tt-||--||-----XXXXXXXXXXXXXX
XXXXXXXXXXXXXXXXXXXXXXXXXXXXXXXXXXXXXXXXXXXXXXXXXXXXXXXXXXXXXX------o-----------------tt-y-----------|XXXXXXXXXXXXXXXXXXXXXXXXXXXXXXXXXXXXXXXXXXXXXXXX
XXXXXXXXXXXXXXXXXXXXXXXXXXXXXXXXXXXXXXXXXXXXXXXXXXXXXXXXXXXXXX-o---------G-o---Y---XXXXXXXXXXXXX-g---|XXXXXXXXXXXXXXXXXXXXXXXXXXXXXXXXXXXXXXXXXXXXXXXX
XXXXXXXXXXXXXXXXXXXXXXXXXXXXXXXXXXXXXXXXXXXXXXXXXXXXXXXXXXXXXXXXXXXXXXXXXXXXXXXXXXXXXXXXXXXXXXXX%%%%%|XXXXXXXXXXXXXXXXXXXXXXXXXXXXXXXXXXXXXXXXXXXXXXXX
XXXXXXXXXXXXXXXXXXXXXXXXXXXXXXXXXXXXXXXXXXXXXXXXXXXXXXXXXXXXXXXXXXXXXXXXXXXXXXXXXXXXXXXXXXXXXXXXXXXXXXXXXXXXXXXXXXXXXXXXXXXXXXXXXXXXXXXXXXXXXXXXXXXXXX
XXXXXXXXXXXXXXXXXXXXXXXXXXXXXXXXXXXXXXXXXXXXXXXXXXXXXXXXXXXXXXXXXXXXXXXXXXXXXXXXXXXXXXXXXXXXXXXXXXXXXXXXXXXXXXXXXXXXXXXXXXXXXXXXXXXXXXXXXXXXXXXXXXXXXX
