------------------------------------------------------------------------------------------------------------------------------------------------------
------------------------------------------------------------------------------------------------------------------------------------------------------
------------------------------------------------------------------------------------------------------------------------------------------------------
------------------------------------------------------------------------------------------------------------g-----------------------------y-----------
----------------------------------------------------------------------------------------------------------%%%%%%----------------------%%%%%%%---------
-------------------------------------------------------gG-Y-----------------------------------------------||||||----------------------|||||||---------
-----------------------------------------------------%%%%%%%----------------------------------------------||||||----------------------|||||||------XXX
-------------------------------------------------%%%-|||||||----------------------------y-------------tt--||||||------------y---------|||||||----F%XXX
-------o-----o-----------------------------------|||-|||||||---------------------------%%%--------o---tttt||||||--tt-o-o---%%%%-------|||||||%%%XXXXXX
------------------------y--g---------------------|||-|||||||-----oo--------------o-----|||------------tttt||||||--tt-------||||----o--||||||||||XXXXXX
------------------%%---%%%%%XXXX---------yYtt----|||-|||||||---------------------%%----|||--------G---tttt||||||-Gtt------XXX||-------||||||||XXXXXXXX
------------------||---|||||XXXX-%%%%%%%tt%tt%--tt|tt|||tt||----------------Y----||----|||---tt-g-XXXXXXXXXXXXXXXXXXXXXXXXXXX||-------||||||||XXXXXXXX
------o----Y-XX---||---||tt|XXXX-|||||tttt|tt|--tt|tt|||tt||tt-----o-------%%%%o-||-o--|||-oott%%%XXXXXXXXXXXXXXXXXXXXXXXXXXX||-------||||||||XXXXXXXX
XXXXXXXXXXXXXXX---||-o-||tt|XXXX-|||||tttt|tt|--tt|tt|||tt||tt--o----------||||--||YGo-|||---tt|||XXXXXXXXXXXXXXXXXXXXXXXXXXXXXX-----G||||||||XXXXXXXX
XXXXXXXXXXXXXXXXXXXXXXXXXXXXXXXXXXXXXXXXXXXXXXXXXXXXXXXXXXXXXXXXXXXXXXXXXXXXXXXXXXXXXXXXXXXXXXXXXXXXXXXXXXXXXXXXXXXXXXXXXXXXXXXXXXXXXXXXXXXXXXXXXXXXXX
XXXXXXXXXXXXXXXXXXXXXXXXXXXXXXXXXXXXXXXXXXXXXXXXXXXXXXXXXXXXXXXXXXXXXXXXXXXXXXXXXXXXXXXXXXXXXXXXXXXXXXXXXXXXXXXXXXXXXXXXXXXXXXXXXXXXXXXXXXXXXXXXXXXXXX
