------------------------------------------------------------------------------------------------------------------------------------------------------
------------------------------------------------------------------------------------------------------------------------------------------------------
------------------------------------------------------------------------------------------------------------------------------------------------------
----------------------------------------------------------------G-------------------------------------------------------------------------------------
---------------------------------------%%o--------------------%%%%--%%--------------------------------------------------------------------gG-gg-------
-----------------------------------o---||-------o-------------||||--||-------------------------------------------go---%%---------------%%%%%%%%%------
-----tt-oo--g--------------------------||------%%%%-----------||||--||---------------------o-tt------------%%%--%%%---||---------------|||||||||------
-----tt----%%%%-------------------o---Y||-g--o-||||-----------||||--||-----------%%----------tt--o---------|||tt|||---||---------------|||||||||------
-----tt----||||--o--tt----------oXXXXXXXXXXXXXXXXX|-----------||||--||---------o-||---------ott----ott-tt--|||tt|||---||---------------|||||||||------
-----tt-XXXX||tt----tt----------GXXXXXXXXXXXXXXXXX|-------tt--||||-tt|-----------||----------tt-----tt-tto-|||tt|||g--||---------------|||||||||------
XXXXXXXXXXXX||tt----tto-------%%%XXXXXXXXXXXXXXXXX|-------tt--||||-tttt-----tt---||--------XXXXXXXXXXXXXXXXXXXXXXXXXXXXXXXXXXXX--------|||||||||------
XXXXXXXXXXXX||tt---Ytt---g--G-|||XXXXXXXXXXXXXXXXX|-------tt--||||-tttt-o---tt---||-tt-----XXXXXXXXXXXXXXXXXXXXXXXXXXXXXXXXXXXX--------|||||||||------
XXXXXXXXXXXXXXXXXXXXXXXXXXXXXXXXXXXXXXXXXXXXXXXXXXXXXXX--XXXXXXXXXXXXXXXX---tt--o||-tt--tt-XXXXXXXXXXXXXXXXXXXXXXXXXXXXXXXXXXXX--------||||||XX|------
XXXXXXXXXXXXXXXXXXXXXXXXXXXXXXXXXXXXXXXXXXXXXXXXXXXXXXX-yXXXXXXXXXXXXXXXXXXXXXXXXXXXXX--tt-XXXXXXXXXXXXXXXXXXXXXXXXXXXXXXXXXXXXXXXXXXXXXXXXXXXXXXF----
XXXXXXXXXXXXXXXXXXXXXXXXXXXXXXXXXXXXXXXXXXXXXXXXXXXXXXXXXXXXXXXXXXXXXXXXXXXXXXXXXXXXXXXXXXXXXXXXXXXXXXXXXXXXXXXXXXXXXXXXXXXXXXXXXXXXXXXXXXXXXXXXXXXXXX
XXXXXXXXXXXXXXXXXXXXXXXXXXXXXXXXXXXXXXXXXXXXXXXXXXXXXXXXXXXXXXXXXXXXXXXXXXXXXXXXXXXXXXXXXXXXXXXXXXXXXXXXXXXXXXXXXXXXXXXXXXXXXXXXXXXXXXXXXXXXXXXXXXXXXX
