------------------------------------------------------------------------------------------------------------------------------------------------------
------------------------------------------------------------------------------------------------------------------------------------------------------
------------------------------------------------------------------------------------------------------------------------------------------------------
----------------------------------------------------------------------------------------------------Y-y-o---------------------------------------------
-------------------------------------------------------%%%%%%%%----------%%%%----------g-----------%%%%%----------------------------------------------
-------------------------------------------------g-----||||||||----------||||---------%%%%%------o-|||||------G-g--y----------------------------------
------------------------------------------------%%%%%%-||||||||----------||||---------|||||---%%---|||||-----%%%%%%%%---------------------------------
------------------------------------------------||||||-||||||||----------||||-o-------|||||---||---|||||-----||||||||---------------------------------
------------o--------------g--------------------||||||-||||||||-------o--||||---------XXXXXXXXXXXXXXXXXXXXX-o||||||||-o-------------------------------
---------o----------------%%%%%-------o-----o---||||||-tt||||||----------||||---------XXXXXXXXXXXXXXXXXXXXX--||||||||---------------------------------
-----------------ott------|||||----tt---------tt||||||-tt||||||tt------tt||||--y------XXXXXXXXXXXXXXXXXXXXX--||||||||--tt-----------------------------
------------------tt--tt--|||||----tt------o--tt||tt||-tt||||||tt------tt||||-XXXXXXXXXXXXXXXXXXXXXXXXXXXXX--||||||||--tt----o-----------------tt-----
--------------tt--tt--tt--|||tt----tt----G----tt||tt||-tt||||||ttY-----tt||||-XXXXXXXXXXXXXXXXXXXXXXXXXXXXXXXXXXXXXXXXXtty---G-----tt-%%----tt-tt-----
-----------XX-tt--tt--tt--|||tt----tt%--XXXXXXXXXXXXXXXXXXXXXXXXXXXXXXXXXXXXXXXXXXXXXXXXXXXXXXXXXXXXXXXXXXXXXXXXXXXXXXXXXXXXXXXXXXott-||oY--tt-ttF----
XXXXXXXXXXXXXXXXXXXXXXXXXXXXXXXXXXXXXXXXXXXXXXXXXXXXXXXXXXXXXXXXXXXXXXXXXXXXXXXXXXXXXXXXXXXXXXXXXXXXXXXXXXXXXXXXXXXXXXXXXXXXXXXXXXXXXXXXXXXXXXXXXXXXXX
XXXXXXXXXXXXXXXXXXXXXXXXXXXXXXXXXXXXXXXXXXXXXXXXXXXXXXXXXXXXXXXXXXXXXXXXXXXXXXXXXXXXXXXXXXXXXXXXXXXXXXXXXXXXXXXXXXXXXXXXXXXXXXXXXXXXXXXXXXXXXXXXXXXXXX
