------------------------------------------------------------------------------------------------------------------------------------------------------
------------------------------------------------------------------------------------------------------------------------------------------------------
------------------------------------------------------------------------------------------------------------------------------------------------------
----------------------------------G----------G-----y--------------------------------------------------------------------------------------------------
-------------%%%%----------------%%%%%--%%--%%%--%%%%--------------------------------%%%%%%--------------------------------------------G--------------
-------------||||----o-----------|||||--||--|||--||||-----------------Y---gg---------||||||--%%%o-------------------------------------%%%-------%%----
-------------||||--------y-------tt|||-tt|--|||--||||-tt-tt----%%%%%%%%%%%%%%%%------||||||--|||--------------tt----------o--o--------|||-------||----
XXXXXXXXXXXXX||||------%%%%%-----tt|||-tt|-tt||--||tt%tt-tt----||||||||||||||||------||||||--|||--------------tt-----o----------tt----|||-------||--o-
XXXXXXXXXXXXX||||--g-G-||||tt----tt|||-tt|-tt||--||tt|tt-tt-o--|||||||||||||||tt----tt|||XXX-|||----oo----o---tttt--------------tto---|||-------||----
XXXXXXXXXXXXXXXXXXXXXX-||||tt----tt|||ytt|-tt||--||tt|tt-tt-g--|||||||||||||||tt----tt|||XXX-|||---g%%--------tttt--%%----------tt----|||---tt--||----
XXXXXXXXXXXXXXXXXXXXXXXXXXXXXXXXXXXXXXXXXXXXXttXXXXXXXXXXXXXXXXXXXXXXXXXXXXXXXXXXXXXtt|||XXX-|XXXXXXXXXXXXXXXXXXXXXXXXXXXXXXXXXXXXXXXXXXX---tt--||----
XXXXXXXXXXXXXXXXXXXXXXXXXXXXXXXXXXXXXXXXXXXXXttXXXXXXXXXXXXXXXXXXXXXXXXXXXXXXXXXXXXXXXXXXXXXXXXXXXXXXXXXXXXXXXXXXXXXXXXXXXXXXXXXXXXXXXXXX---tt--|F----
XXXXXXXXXXXXXXXXXXXXXXXXXXXXXXXXXXXXXXXXXXXXXXXXXXXXXXXXXXXXXXXXXXXXXXXXXXXXXXXXXXXXXXXXXXXXXXXXXXXXXXXXXXXXXXXXXXXXXXXXXXXXXXXXXXXXXXXXXXXXXXXXXXXXXX
XXXXXXXXXXXXXXXXXXXXXXXXXXXXXXXXXXXXXXXXXXXXXXXXXXXXXXXXXXXXXXXXXXXXXXXXXXXXXXXXXXXXXXXXXXXXXXXXXXXXXXXXXXXXXXXXXXXXXXXXXXXXXXXXXXXXXXXXXXXXXXXXXXXXXX
XXXXXXXXXXXXXXXXXXXXXXXXXXXXXXXXXXXXXXXXXXXXXXXXXXXXXXXXXXXXXXXXXXXXXXXXXXXXXXXXXXXXXXXXXXXXXXXXXXXXXXXXXXXXXXXXXXXXXXXXXXXXXXXXXXXXXXXXXXXXXXXXXXXXXX
XXXXXXXXXXXXXXXXXXXXXXXXXXXXXXXXXXXXXXXXXXXXXXXXXXXXXXXXXXXXXXXXXXXXXXXXXXXXXXXXXXXXXXXXXXXXXXXXXXXXXXXXXXXXXXXXXXXXXXXXXXXXXXXXXXXXXXXXXXXXXXXXXXXXXX
