-----------------------------------------------------------------------------------------------------------------------------------------o------------
-------------------------------------------------------------------------------------------------------------------o-o-------------------tt-tt--------
-----------------o---------------------------------------------------------------------------------------------------------o--tt---------tt-tt--------
--------------------------------------------------------G-o---------------------------------------------------tt----G---tt----tt-----o---tt-tt--------
--------------------%%-------o---------%%%%------------%%%--tt----------------------------g---g----------o----tt%%%%%%%ott----tt------%%-tt-tt----tt--
--------------------||---G-------------||||-----------o|||--tt---------------------------%%%%%%%tt----%%%-----tt|||||||%tto---ttgXXXXXXXXXXXXX-tt-tt--
-----------------XXXXXX-%%%%%%%%%%%-tt-||||--ttoo--o--tt||--tt---------------------------||||tt|tt----|||---XXXXXXXXXXXXXXXXXXXXXXXXXXXXXXXXXX-tt-tto-
-----------------XXXXXX-||||tt|||||-tt-||||--tt-------tt||-Gtt---------------------------||||tt|tt----|||---XXXXXXXXXXXXXXXXXXXXXXXXXXXXXXXXXXGttFtt-y
-------tt--------XXXXXX-||||tt|||||-tt-||||--tt-XXXXXXXXXXXXXXG---o----------------------||||tt|tt----|||---XXXXXXXXXXXXXXXXXXXXXXXXXXXXXXXXXXXXXXXXXX
-------tt-------GXXXXXXXXXXXXXXXXXXXXXXXXXXXXXXXXXXXXXXXXXXXXXXX---o--------------------XXXXXXXXXXXXXXXXXXXXXXXXXXXXXXXXXXXXXXXXXXXXXXXXXXXXXXXXXXXXXX
XXXXXXXXXXXXXXXXXXXXXXXXXXXXXXXXXXXXXXXXXXXXXXXXXXXXXXXXXXXXXXXX----tt----------o--tt---XXXXXXXXXXXXXXXXXXXXXXXXXXXXXXXXXXXXXXXXXXXXXXXXXXXXXXXXXXXXXX
XXXXXXXXXXXXXXXXXXXXXXXXXXXXXXXXXXXXXXXXXXXXXXXXXXXXXXXXXXXXXXXX-tt-ttott----------tt---XXXXXXXXXXXXXXXXXXXXXXXXXXXXXXXXXXXXXXXXXXXXXXXXXXXXXXXXXXXXXX
XXXXXXXXXXXXXXXXXXXXXXXXXXXXXXXXXXXXXXXXXXXXXXXXXXXXXXXXXXXXXXXX-tt-tt-tt----------tt%%%XXXXXXXXXXXXXXXXXXXXXXXXXXXXXXXXXXXXXXXXXXXXXXXXXXXXXXXXXXXXXX
XXXXXXXXXXXXXXXXXXXXXXXXXXXXXXXXXXXXXXXXXXXXXXXXXXXXXXXXXXXXXXXXXXXXXXXXXXXXXXXXXXXXXXXXXXXXXXXXXXXXXXXXXXXXXXXXXXXXXXXXXXXXXXXXXXXXXXXXXXXXXXXXXXXXXX
XXXXXXXXXXXXXXXXXXXXXXXXXXXXXXXXXXXXXXXXXXXXXXXXXXXXXXXXXXXXXXXXXXXXXXXXXXXXXXXXXXXXXXXXXXXXXXXXXXXXXXXXXXXXXXXXXXXXXXXXXXXXXXXXXXXXXXXXXXXXXXXXXXXXXX
XXXXXXXXXXXXXXXXXXXXXXXXXXXXXXXXXXXXXXXXXXXXXXXXXXXXXXXXXXXXXXXXXXXXXXXXXXXXXXXXXXXXXXXXXXXXXXXXXXXXXXXXXXXXXXXXXXXXXXXXXXXXXXXXXXXXXXXXXXXXXXXXXXXXXX
