------------------------------------------------------------------------------------------------------------------------------------------------------
------------------------------------------------------------------------------------------------------------------------------------------------------
------------------------------------------------------------------------------------------------------------------------------------------------------
------------------------------------------------------------------------------------------------------------------------------------------------------
------------------------------------------------------------------------------------------------------------------------------------------------------
------------------------------------------------------------------------------------------------------------------------------------------------------
-------------%%------------------------------G---G---------%%---------------------------------------------------------------------------------------o-
-------------||------------------------%%%%%%%%%%%%--------||--------------------------------------------------------o-------------------%%%%---------
-------------||------------------------||||||||||||--------||---------------%%%-----------------------------o-------------tt-----o--oo---||||---tt---o
-------------||----------o-------------||||||||||||--------||--o-----o------|||------------------%%%%%--------------tt-tt-tto------------||||---tt--tt
-------------||------------------------|||||||||||tt-------||-----------o---|||------------------|||||----o---------tt-tt-tt-------------||||---tFG-tt
------o---tt-tt----------------o--%%%-o|||||||||||tt----tt-||tt-------------|||--------------o---|||||---%%-XXXXXXXXXXXXXXXXXXXXXXXXXXXXXXXXXXXXXXXXXX
----------tt-tt-o--tt-------%%----|||--||||||tt|tttt-o--tt-||tt-------------|||------XXXo--------|||||---||-XXXXXXXXXXXXXXXXXXXXXXXXXXXXXXXXXXXXXXXXXX
----------tt-ttg-o-tt%%-G---||GYg-|||--||||||tt|ttttG---tt-||tt-------------|||-o----XXXG--------|||||-G-||-XXXXXXXXXXXXXXXXXXXXXXXXXXXXXXXXXXXXXXXXXX
XXXXXXXXXXXXXXXXXXXXXXXXXXXXXXXXXXXXXXXXXXXXXXXXXXXXXXXXXXXXXXXXXXXXXXXXXXXXXXXXXXXXXXXXXXXXXXXXXXXXXXXXXXXXXXXXXXXXXXXXXXXXXXXXXXXXXXXXXXXXXXXXXXXXXX
XXXXXXXXXXXXXXXXXXXXXXXXXXXXXXXXXXXXXXXXXXXXXXXXXXXXXXXXXXXXXXXXXXXXXXXXXXXXXXXXXXXXXXXXXXXXXXXXXXXXXXXXXXXXXXXXXXXXXXXXXXXXXXXXXXXXXXXXXXXXXXXXXXXXXX
