------------------------------------------------------------------------------------------------------------------------------------------------------
----------------------------------------------------------------------------------------------------------tt------------------------------------------
----------------------------------------------------------------------------------------------------------tt----------------o-------------------------
------------------------------------------------------------------------------------------o-------------tttt-------------tt------------o--------------
------------------------------------------------------------------------------oo----o--ott----%%----o---tttt-------------tt---o-----------------------
-----------------------------------------------o----------------tt----------------------tt----tt------XXXXXXX------------tt--o---tt-------------------
---------------------------------------------o----G-------------tttt------%%%-----------tt----tt-o-oXXXXXXXXX----G-------tty-G---tt-%%%%-----o------tt
-----------------------o--------o----------------%%%%-----------tttty--o--|||-----o-----tt--%%tt----XXXXXXXXXXXXXXXXXXXXXXXXXXXXXXXXXXXXXXX---------tt
------------tt-----------------------------------||||-----oXXXXXXXXXXXXXXXXXXXXXXXXXXXXXXXXXXXXXXXXXXXXXXXXXXXXXXXXXXXXXXXXXXXXXXXXXXXXXXXX---------tt
--------o---tt-%%%%%----------------------------g||||------XXXXXXXXXXXXXXXXXXXXXXXXXXXXXXXXXXXXXXXXXXXXXXXXXXXXXXXXXXXXXXXXXXXXXXXXXXXXXXXXYo--g-Fo-tt
-------o----tt-|||||--------tt--------------XXXXXXX||------XXXXXXXXXXXXXXXXXXXXXXXXXXXXXXXXXXXXXXXXXXXXXXXXXXXXXXXXXXXXXXXXXXXXXXXXXXXXXXXXXXXXXXXXXXX
------------tt-|||||-G------tt--XXXXX------oXXXXXXX||--Y-G-XXXXXXXXXXXXXXXXXXXXXXXXXXXXXXXXXXXXXXXXXXXXXXXXXXXXXXXXXXXXXXXXXXXXXXXXXXXXXXXXXXXXXXXXXXX
---------XXXXXXXXXXXXXXXX---tt--XXXXX-------XXXXXXXXXXXXXXXXXXXXXXXXXXXXXXXXXXXXXXXXXXXXXXXXXXXXXXXXXXXXXXXXXXXXXXXXXXXXXXXXXXXXXXXXXXXXXXXXXXXXXXXXXX
---------XXXXXXXXXXXXXXXX---tt-YXXXXX--%%%%%XXXXXXXXXXXXXXXXXXXXXXXXXXXXXXXXXXXXXXXXXXXXXXXXXXXXXXXXXXXXXXXXXXXXXXXXXXXXXXXXXXXXXXXXXXXXXXXXXXXXXXXXXX
XXXXXXXXXXXXXXXXXXXXXXXXXXXXXXXXXXXXXXXXXXXXXXXXXXXXXXXXXXXXXXXXXXXXXXXXXXXXXXXXXXXXXXXXXXXXXXXXXXXXXXXXXXXXXXXXXXXXXXXXXXXXXXXXXXXXXXXXXXXXXXXXXXXXXX
XXXXXXXXXXXXXXXXXXXXXXXXXXXXXXXXXXXXXXXXXXXXXXXXXXXXXXXXXXXXXXXXXXXXXXXXXXXXXXXXXXXXXXXXXXXXXXXXXXXXXXXXXXXXXXXXXXXXXXXXXXXXXXXXXXXXXXXXXXXXXXXXXXXXXX
