------------------------------------------------------------------------------------------------------------------------------------------------------
------------------------------------------------------------------------------------------------------------------------------------------------------
------------------------------------------------------------------------------------------------------------------------------------------------------
-----------------------------------------------------------------------------------------------------------------------------------------------------y
----------------------G-g--------------tt-----------------------------------------------%%--------------------------------------------------%%%----%%%
------------------%%%%%%%%%----Y-o-----tto----------------------------------------------||--------------------------------------------------|||----|||
------------------|||||||||-%%%%%%tt---tt-------g---------------------------------------||--------------------------------------------------|||----|||
------------------|||||||||-||||||tt-G-tt----%%%%%%----------------------------------%%-||------------%%%-----------------------------------|||----|||
--------o---------|||||||||-||XXXXXXXXXXXX---||||||----------------------------------||-||------------|||-----------------------------------|||----|tt
------------------|||||||||-||XXXXXXXXXXXX--gtt||||--------o-------------o---------o-||-||-o-o--o-----|||-----------------------------------|||----|tt
------------------|||||||||o||XXXXXXXXXXXXXXXtt||||-----o---------------------o------||-||------------|||------tt-----tt-----------------tt-|||----|tt
------------------|||||XXXXXXXXXXXXXXXXXXXXXXXXXX||------g----%%%--------------tt----||-tt------------|||------tt-----ttG--tt---------o--tt-|||----XXX
-----------%%-----XXXXXXXXXXXXXXXXXXXXXXXXXXXXXXX||--o--tt%---|||--------------tt----||-tt------------|||-o-otttt-tt--tt%%%tt------------tt-|||tt--XXX
XXXXXXXXXXXXXXXXXXXXXXXXXXXXXXXXXXXXXXXXXXXXXXXXX||----Gtt|-Y-|||--G-----gG----ttY---||-tt---g--G-----|||-Go-tttt-tt--tt|||ttg-----------tt-|||ttF-XXX
XXXXXXXXXXXXXXXXXXXXXXXXXXXXXXXXXXXXXXXXXXXXXXXXXXXXXXXXXXXXXXXXXXXXXXXXXXXXXXXXXXXXXXXXXXXXXXXXXXXXXXXXXXXXXXXXXXXXXXXXXXXXXXXXXXXXXXXXXXXXXXXXXXXXXX
XXXXXXXXXXXXXXXXXXXXXXXXXXXXXXXXXXXXXXXXXXXXXXXXXXXXXXXXXXXXXXXXXXXXXXXXXXXXXXXXXXXXXXXXXXXXXXXXXXXXXXXXXXXXXXXXXXXXXXXXXXXXXXXXXXXXXXXXXXXXXXXXXXXXXX
