------------------------------------------------------------------------------------------------------------------------------------------------------
-------------------------------------------------------------------------------------------------------------o----------------------------------------
------------------------------------------------------------------------------------------------------------------------------------------------------
---------------------------------------------------------------------------------------------------------------oo--o---------------o------------------
---------------------------------%%%%--------------------------------------------o----------------------------o---------tto------------------------o--
---------------------------------||||------------------o---------------------------------------%%%%-------------------%%tt--------------------tt------
---------tt----------------------||||--------------o----------g-------og-------tt--------------||||---------XXXXXXX---||tt------------------tttt---tt-
---------tt---%%-----------------||||----------o-------------%%%%----%%%%%%----tt-tt-----------||||---------XXXXXXX-G-||tt---G----yY---go---tttt-F-tt-
---------tt-o-tt--tt---------tt-tt|||---------------g--tt---o||||o---||||||----ttGtt--g--------||||------g--XXXXXXXXXXXXXXXXXXXXXXXXXXXXXXXXXXXXXXXXXX
--------Gtt---tt--ttY--------tt-tt|||----o---------%%%-tt----||||XXXXXXXXXXXXXXXXXXXXXX%%%%----||tt---%%%%%%XXXXXXXXXXXXXXXXXXXXXXXXXXXXXXXXXXXXXXXXXX
XXXXXXXXXXXXXXXX--tt%%-------tt-tt|||-------XXXXXXXXXXXXXX---||||XXXXXXXXXXXXXXXXXXXXXX|||tt---||tt---|||XXXXXXXXXXXXXXXXXXXXXXXXXXXXXXXXXXXXXXXXXXXXX
XXXXXXXXXXXXXXXX--tt||o----G-tt-tt|||-------XXXXXXXXXXXXXXXXXXXXXXXXXXXXXXXXXXXXXXXXXXX|||tt---||tt---|ttXXXXXXXXXXXXXXXXXXXXXXXXXXXXXXXXXXXXXXXXXXXXX
XXXXXXXXXXXXXXXXXXXXXXXXXXXXXXXXXXXXXXXXXXXXXXXXXXXXXXXXXXXXXXXXXXXXXXXXXXXXXXXXXXXXXXX|||tt---||ttgG-|ttXXXXXXXXXXXXXXXXXXXXXXXXXXXXXXXXXXXXXXXXXXXXX
XXXXXXXXXXXXXXXXXXXXXXXXXXXXXXXXXXXXXXXXXXXXXXXXXXXXXXXXXXXXXXXXXXXXXXXXXXXXXXXXXXXXXXXXXXXXXXXXXXXXXX|ttXXXXXXXXXXXXXXXXXXXXXXXXXXXXXXXXXXXXXXXXXXXXX
XXXXXXXXXXXXXXXXXXXXXXXXXXXXXXXXXXXXXXXXXXXXXXXXXXXXXXXXXXXXXXXXXXXXXXXXXXXXXXXXXXXXXXXXXXXXXXXXXXXXXXXXXXXXXXXXXXXXXXXXXXXXXXXXXXXXXXXXXXXXXXXXXXXXXX
XXXXXXXXXXXXXXXXXXXXXXXXXXXXXXXXXXXXXXXXXXXXXXXXXXXXXXXXXXXXXXXXXXXXXXXXXXXXXXXXXXXXXXXXXXXXXXXXXXXXXXXXXXXXXXXXXXXXXXXXXXXXXXXXXXXXXXXXXXXXXXXXXXXXXX
