-------------------------------------------------o------------------------------------------------------------------------------------------o---------
--------------------o----------o-----o-----o-tt----------------------------------------------------------------------------------------------tt-------
---------------------------------------------tt------tt------o-------------------------------------------------------------------------o-----tt----o--
---------------------GG--------tt------o-----tt----tttt-----GG--------------------------------------------------------------------------o-g--tt-g-----
--------------------%%%%--yo---tt-------g--%%tto---tttt----%%%%---------------oo--%%---o--------------------------------------------o----%%%-tt%%F--o-
--------------------XXXXXXXXXXXXXXXXXXXXXXXXXXXXXXXXXXXXXXXXXX|---o-------------%%||-----tt-------------------------------------o-XXXXXXXXXXXXXXXXXXXX
--------------------XXXXXXXXXXXXXXXXXXXXXXXXXXXXXXXXXXXXXXXXXX|-----------------||||-----tt---------------------------------------XXXXXXXXXXXXXXXXXXXX
--------------------XXXXXXXXXXXXXXXXXXXXXXXXXXXXXXXXXXXXXXXXXX|%%tt-------------||tt---tttt-------------------------o-o-----------XXXXXXXXXXXXXXXXXXXX
--------------------XXXXXXXXXXXXXXXXXXXXXXXXXXXXXXXXXXXXXXXXXX|||tt---Y-Y-----G-||tt-o-tttt----%%-------o-----------------------G-XXXXXXXXXXXXXXXXXXXX
-------------G-Y--XXXXXXXXXXXXXXXXXXXXXXXXXXXXXXXXXXXXXXXXXXXXXXXXXXXXXXXXXXXXXXXXXXXXXXXXXX-o-||---------GG-G-------------tt---XXXXXXXXXXXXXXXXXXXXXX
------------%%%%%-XXXXXXXXXXXXXXXXXXXXXXXXXXXXXXXXXXXXXXXXXXXXXXXXXXXXXXXXXXXXXXXXXXXXXXXXXX---|tt-----tt%%%%%%------------tt---XXXXXXXXXXXXXXXXXXXXXX
------------|||||-XXXXXXXXXXXXXXXXXXXXXXXXXXXXXXXXXXXXXXXXXXXXXXXXXXXXXXXXXXXXXXXXXXXXXXXXXX---|tt%%%--tt||||||-G------G---tt---XXXXXXXXXXXXXXXXXXXXXX
------------|||||-XXXXXXXXXXXXXXXXXXXXXXXXXXXXXXXXXXXXXXXXXXXXXXXXXXXXXXXXXXXXXXXXXXXXXXXXXXXXXXXXXXXXXXXXXXXXXXXXXXXXXXXXXXXXXXXXXXXXXXXXXXXXXXXXXXXX
------G---g-||XXXXXXXXXXXXXXXXXXXXXXXXXXXXXXXXXXXXXXXXXXXXXXXXXXXXXXXXXXXXXXXXXXXXXXXXXXXXXXXXXXXXXXXXXXXXXXXXXXXXXXXXXXXXXXXXXXXXXXXXXXXXXXXXXXXXXXXX
XXXXXXXXXXXXXXXXXXXXXXXXXXXXXXXXXXXXXXXXXXXXXXXXXXXXXXXXXXXXXXXXXXXXXXXXXXXXXXXXXXXXXXXXXXXXXXXXXXXXXXXXXXXXXXXXXXXXXXXXXXXXXXXXXXXXXXXXXXXXXXXXXXXXXX
XXXXXXXXXXXXXXXXXXXXXXXXXXXXXXXXXXXXXXXXXXXXXXXXXXXXXXXXXXXXXXXXXXXXXXXXXXXXXXXXXXXXXXXXXXXXXXXXXXXXXXXXXXXXXXXXXXXXXXXXXXXXXXXXXXXXXXXXXXXXXXXXXXXXXX
