------------------------------------------------------------------------------------------------------------------------------------------------------
------------------------------------------------------------------------------------------------------------------------------------------------------
------------------------------------------------------------------------------------------------------------------------------------------------------
------------------------------------------------------------------------------------------------------------------------------------------------------
------------------------------------------------------------------------------------------------------------------------------------------------------
---------------------------------------------------------------------------------------------g-----g------------%%------------------------------------
-------------------------------------------------------------------------------------------%%%%%%%%%%-----------||---------%%-------------------------
-------------------------------------------------------------------------------------------||||||||||-----------||-%%%%----||-------------------------
-------------tt-----tt---------------------------------------------------------------------||||||||||-------o---||-||||----||-Yg---g------g------%%%%-
-------------tt-----tt----Ytt--o------------o-----------------------------G-------o--------||||||||||-----------||-||||----||%%%%%%%%%%%%%%%%----||||-
--------Y---gtto----tto--%%tt----------------o---------------------------%%%---------------||||||||||-----------||-||||----||||||||||||||||||----||tto
XXXXXXXXXXXXXXXXXXXXXXXXXXXXXXXX----------o----o-------------------------|tt---------------||||||||||----------o||-||tt----||||||||||||||||||-o--||tt-
XXXXXXXXXXXXXXXXXXXXXXXXXXXXXXXX-----------o-----------------------------|tt---------------||||||||||oy-o-------||-tttt----||||||||||||||||||--o-||tt-
XXXXXXXXXXXXXXXXXXXXXXXXXXXXXXXX-----g-------------o---------o------oo---|tt---G-----yo----||||||||||XXXXXXXX---||-tttt%%%%||||||||||||||||||----F|tt-
XXXXXXXXXXXXXXXXXXXXXXXXXXXXXXXXXXXXXXXXXXXXXXXXXXXXXXXXXXXXXXXXXXXXXXXXXXXXXXXXXXXXXXXXXXXXXXXXXXXXXXXXXXXXXXXXXXXXXXXXXXXXXXXXXXXXXXXXXXXXXXXXXXXXXX
XXXXXXXXXXXXXXXXXXXXXXXXXXXXXXXXXXXXXXXXXXXXXXXXXXXXXXXXXXXXXXXXXXXXXXXXXXXXXXXXXXXXXXXXXXXXXXXXXXXXXXXXXXXXXXXXXXXXXXXXXXXXXXXXXXXXXXXXXXXXXXXXXXXXXX
