------------------------------------------------------------------------------------------------------------------------------------------------------
-------------------------------------------o----------------------------------------------------------------------------------------------------------
------------------------------------------------------------------------------------------------------------------------------------------------------
------------------------------------------------------------------------------------------------------------------------------------------------------
----------------------------------Y-o------%%o---Go-------------%%%-------------------------------%%%--------------------o--------o-----------------o-
------------------------tt--tt--%%%%tt---o-||XXXXXX-------------|||-------------------------------|||-------------------------%%------y-o---%%%-------
------------------------tt--tto-||||tt-XXXXXXXXXXXX-------------|||-------------------------------|||----o-------o--tt--o-----||-----%%%---tt||------o
------------------------tt-ytt-tt|||tt-XXXXXXXXXXXX-------------|||-----------------------------o-|||-o%%---o-o-----tt---XXXXXXXXXXXXXX|---tt||----XXX
-----------------o------tt%%tt-tt|||tt-XXXXXXXXXXXXo--o---------|||-------o----o-----------tt--o--|||--||-----------tt---XXXXXXXXXXXXXXXXXXXXX|----XXX
----------------------XXXXXXXXXXXXXXXXXXXXXXXXXXXXXXXX-tt---o---|||---------%%%%-----------tt-----|||--||-------XXXXXXXXXXXXXXXXXXXXXXXXXXXXXX|%%%%XXX
-------------o------o-XXXXXXXXXXXXXXXXXXXXXXXXXXXXXXXX-tt-------|||---------||||---o-------tt---g-|||--||---G---XXXXXXXXXXXXXXXXXXXXXXXXXXXXXX|||F|XXX
XXXXXXXX--------------XXXXXXXXXXXXXXXXXXXXXXXXXXXXXXXX-tt----o--|||-tt----tt||||-------ttXXXXXXXXXXXXXXXXXXXXXXXXXXXXXXXXXXXXXXXXXXXXXXXXXXXXXXXXXXXXX
XXXXXXXX------%%XXXXXXXXXXXXXXXXXXXXXXXXXXXXXXXXXXXXXX-tt-G-G---|||gtt----tt||||-G----gttXXXXXXXXXXXXXXXXXXXXXXXXXXXXXXXXXXXXXXXXXXXXXXXXXXXXXXXXXXXXX
XXXXXXXX-----G||XXXXXXXXXXXXXXXXXXXXXXXXXXXXXXXXXXXXXXXXXXXXXXXXXXXXXXXXXXXXXXXXXXXXXXXXXXXXXXXXXXXXXXXXXXXXXXXXXXXXXXXXXXXXXXXXXXXXXXXXXXXXXXXXXXXXXX
XXXXXXXXXXXXXXXXXXXXXXXXXXXXXXXXXXXXXXXXXXXXXXXXXXXXXXXXXXXXXXXXXXXXXXXXXXXXXXXXXXXXXXXXXXXXXXXXXXXXXXXXXXXXXXXXXXXXXXXXXXXXXXXXXXXXXXXXXXXXXXXXXXXXXX
XXXXXXXXXXXXXXXXXXXXXXXXXXXXXXXXXXXXXXXXXXXXXXXXXXXXXXXXXXXXXXXXXXXXXXXXXXXXXXXXXXXXXXXXXXXXXXXXXXXXXXXXXXXXXXXXXXXXXXXXXXXXXXXXXXXXXXXXXXXXXXXXXXXXXX
