------------------------------------------------------------------------------------------------------------------------------------------------------
----------o-----o----------------------------------------------------------------------------------o-------------------------------------------o------
---------o-------------------------------------------------------------------o---------------------------------------------------tt-------------------
------tt-----tt----o------------------------------------------------------------------o--------tt----ottg--------g-------o------ottG-tt-o-------------
------tt---tttt--------------------------%%----------------g-YYy--G-------o--------------------tt%%---tt%%--%%%-%%%-----o------tttt%%tt---g----y-F--%%
------tt---tttt-----g--Y-----------------||---------------%%%%%%%%%%--------------------Y---o-XXXXXXXXXXXXXXXXXXX||--o---------tttt|XXXXXXXXXXXXXXXXX|
XXXXXXXXXXXXXXXXX--%%%%%%----------------||--o------------||||||||||--------%%%---o--XXXXXXXXXXXXXXXXXXXXXXXXXXXX||---------oXXXXXXXXXXXXXXXXXXXXXXXX|
XXXXXXXXXXXXXXXXXXXXXXXXXXX--%%%%%%%-----||--------tt-----||||||||||-o-XXXXXXXXXXXXXXXXXXXXXXXXXXXXXXXXXXXXXXXXXX||----------XXXXXXXXXXXXXXXXXXXXXXXX|
XXXXXXXXXXXXXXXXXXXXXXXXXXX--|||||||-----||---Y----tt-YG--||||||||||---XXXXXXXXXXXXXXXXXXXXXXXXXXXXXXXXXXXXXXXXXXXXXXXXXXXXXXXXXXXXXXXXXXXXXXXXXXXXXX|
XXXXXXXXXXXXXXXXXXXXXXXXXXXXXXXXXXXXXXXXX||XXXXXXXXXXXXXXXXXXXXXXXXXX--XXXXXXXXXXXXXXXXXXXXXXXXXXXXXXXXXXXXXXXXXXXXXXXXXXXXXXXXXXXXXXXXXXXXXXXXXXXXXXX
XXXXXXXXXXXXXXXXXXXXXXXXXXXXXXXXXXXXXXXXX||XXXXXXXXXXXXXXXXXXXXXXXXXXXXXXXXXXXXXXXXXXXXXXXXXXXXXXXXXXXXXXXXXXXXXXXXXXXXXXXXXXXXXXXXXXXXXXXXXXXXXXXXXXX
XXXXXXXXXXXXXXXXXXXXXXXXXXXXXXXXXXXXXXXXXXXXXXXXXXXXXXXXXXXXXXXXXXXXXXXXXXXXXXXXXXXXXXXXXXXXXXXXXXXXXXXXXXXXXXXXXXXXXXXXXXXXXXXXXXXXXXXXXXXXXXXXXXXXXX
XXXXXXXXXXXXXXXXXXXXXXXXXXXXXXXXXXXXXXXXXXXXXXXXXXXXXXXXXXXXXXXXXXXXXXXXXXXXXXXXXXXXXXXXXXXXXXXXXXXXXXXXXXXXXXXXXXXXXXXXXXXXXXXXXXXXXXXXXXXXXXXXXXXXXX
XXXXXXXXXXXXXXXXXXXXXXXXXXXXXXXXXXXXXXXXXXXXXXXXXXXXXXXXXXXXXXXXXXXXXXXXXXXXXXXXXXXXXXXXXXXXXXXXXXXXXXXXXXXXXXXXXXXXXXXXXXXXXXXXXXXXXXXXXXXXXXXXXXXXXX
XXXXXXXXXXXXXXXXXXXXXXXXXXXXXXXXXXXXXXXXXXXXXXXXXXXXXXXXXXXXXXXXXXXXXXXXXXXXXXXXXXXXXXXXXXXXXXXXXXXXXXXXXXXXXXXXXXXXXXXXXXXXXXXXXXXXXXXXXXXXXXXXXXXXXX
XXXXXXXXXXXXXXXXXXXXXXXXXXXXXXXXXXXXXXXXXXXXXXXXXXXXXXXXXXXXXXXXXXXXXXXXXXXXXXXXXXXXXXXXXXXXXXXXXXXXXXXXXXXXXXXXXXXXXXXXXXXXXXXXXXXXXXXXXXXXXXXXXXXXXX
