---------------------------o--------------------------------------------------------------------------------------------------------------------------
----------------------------o-------------------------------------------------------------------------------------------------------------------------
-----------------------------tt----tt-----------------------------------------------------------------------------------------------------------------
--------------o--------------tt---ott---o------------------------------------------------------------------------o----------------------------o-------
------------%%%-----------y--tt----tt%--------------------------------------------------o-----------%%%%%%----%%--------o----------G%%--g-------o-----
------------|||--------o--XXXXXXXXXXXXX--------------------------------------o----------------------|||||tt-ttXXX----o-----o---XXXXXXXXXX-o---------G-
XXXXXXXXXXXXXXX-----------XXXXXXXXXXXXX------%%%%%-----------o--o-----o------------------------o----|||||tt-ttXXX------%%%o----XXXXXXXXXX-----yg--%%%%
XXXXXXXXXXXXXXXo----o-XXXXXXXXXXXXXXXXXXX--o-|||||----------------------------------G---g-----------|||||tt%ttXXX----%%|||----oXXXXXXXXXXXXXXXXX-F||||
XXXXXXXXXXXXXXX--tt---XXXXXXXXXXXXXXXXXXX-o--|||||----g--------%%%-----------tt-XXXXXXXXXXXXXXXXXXXXXXXXXXXXXXXXXXXXXXXXXXXXXXXXXXXXXXXXXXXXXXXXXXXXXX
XXXXXXXXXXXXXXX--tty--XXXXXXXXXXXXXXXXXXXXXXXXXXXXXXXXXXX-o--y-|||-g-g--y----tt-XXXXXXXXXXXXXXXXXXXXXXXXXXXXXXXXXXXXXXXXXXXXXXXXXXXXXXXXXXXXXXXXXXXXXX
XXXXXXXXXXXXXXXXXXXXXXXXXXXXXXXXXXXXXXXXXXXXXXXXXXXXXXXXXXXXXXXXXXXXXXXXXXXXXXXXXXXXXXXXXXXXXXXXXXXXXXXXXXXXXXXXXXXXXXXXXXXXXXXXXXXXXXXXXXXXXXXXXXXXXX
XXXXXXXXXXXXXXXXXXXXXXXXXXXXXXXXXXXXXXXXXXXXXXXXXXXXXXXXXXXXXXXXXXXXXXXXXXXXXXXXXXXXXXXXXXXXXXXXXXXXXXXXXXXXXXXXXXXXXXXXXXXXXXXXXXXXXXXXXXXXXXXXXXXXXX
XXXXXXXXXXXXXXXXXXXXXXXXXXXXXXXXXXXXXXXXXXXXXXXXXXXXXXXXXXXXXXXXXXXXXXXXXXXXXXXXXXXXXXXXXXXXXXXXXXXXXXXXXXXXXXXXXXXXXXXXXXXXXXXXXXXXXXXXXXXXXXXXXXXXXX
XXXXXXXXXXXXXXXXXXXXXXXXXXXXXXXXXXXXXXXXXXXXXXXXXXXXXXXXXXXXXXXXXXXXXXXXXXXXXXXXXXXXXXXXXXXXXXXXXXXXXXXXXXXXXXXXXXXXXXXXXXXXXXXXXXXXXXXXXXXXXXXXXXXXXX
XXXXXXXXXXXXXXXXXXXXXXXXXXXXXXXXXXXXXXXXXXXXXXXXXXXXXXXXXXXXXXXXXXXXXXXXXXXXXXXXXXXXXXXXXXXXXXXXXXXXXXXXXXXXXXXXXXXXXXXXXXXXXXXXXXXXXXXXXXXXXXXXXXXXXX
XXXXXXXXXXXXXXXXXXXXXXXXXXXXXXXXXXXXXXXXXXXXXXXXXXXXXXXXXXXXXXXXXXXXXXXXXXXXXXXXXXXXXXXXXXXXXXXXXXXXXXXXXXXXXXXXXXXXXXXXXXXXXXXXXXXXXXXXXXXXXXXXXXXXXX
