--------------------------------------------------------------------------------------------------------------------------------------o---------o-----
----------------------------------------------------------------------------------------------------------------o--------------------------o-o--------
-------------------------------------------------------------------------------------------------------------------------------------o---o--o---------
------------------------------------------------------------------------------------------------------------------g------o---------y--go--o----o------
-------------------------------------------------------------------gG--------------------------------------------%%%%-o-------Y--%%%%%%%----g----F-G--
------------------------------------------------------------------%%%%---------%%%-----------------------o-------||||----XXXXXXXXXXXXXXXXXXXXXXXXXXXXX
-------------------------------------------tto--------o-o---------||||---------|||----------------tt----tt----XXXXX||--yyXXXXXXXXXXXXXXXXXXXXXXXXXXXXX
-------------------------------------------tt----o-tt-------------||||---------|||----------------tt----tt----XXXXXXXXXXXXXXXXXXXXXXXXXXXXXXXXXXXXXXXX
-------------------------------------------tt%%----tt%%%--tt------||||---------|||----------------tt----tt----XXXXXXXXXXXXXXXXXXXXXXXXXXXXXXXXXXXXXXXX
-------o---------------o------------o------tt||%%%%tt|||--tt------||||---tt----|||--o-------------tt----tt---oXXXXXXXXXXXXXXXXXXXXXXXXXXXXXXXXXXXXXXXX
-----tt------------tt--tttt--%%%%%%%%%%%%XXXXXXXXXXXXXXXXXXXo-----||||---tt--o-|||--------o-ttXXXXXXXXXXXXXXXXXXXXXXXXXXXXXXXXXXXXXXXXXXXXXXXXXXXXXXXX
-----tt-------g-gG-tt--tttt--||tt||||||||XXXXXXXXXXXXXXXXXXX------||||---tt---o|||------o---ttXXXXXXXXXXXXXXXXXXXXXXXXXXXXXXXXXXXXXXXXXXXXXXXXXXXXXXXX
-----tt------%%%%%%tto-tttt--||tt||||||||XXXXXXXXXXXXXXXXXXX-G----||||-G-ttoo--|||-g----g---ttXXXXXXXXXXXXXXXXXXXXXXXXXXXXXXXXXXXXXXXXXXXXXXXXXXXXXXXX
-----ttGG----||||||tt--tttt-g||tt||||||||XXXXXXXXXXXXXXXXXXXXXXXXXXXXXXXXXXXXXXXXXXXXXXXXXXXXXXXXXXXXXXXXXXXXXXXXXXXXXXXXXXXXXXXXXXXXXXXXXXXXXXXXXXXXX
XXXXXXXXXXXXXXXXXXXXXXXXXXXXXXXXXXXXXXXXXXXXXXXXXXXXXXXXXXXXXXXXXXXXXXXXXXXXXXXXXXXXXXXXXXXXXXXXXXXXXXXXXXXXXXXXXXXXXXXXXXXXXXXXXXXXXXXXXXXXXXXXXXXXXX
XXXXXXXXXXXXXXXXXXXXXXXXXXXXXXXXXXXXXXXXXXXXXXXXXXXXXXXXXXXXXXXXXXXXXXXXXXXXXXXXXXXXXXXXXXXXXXXXXXXXXXXXXXXXXXXXXXXXXXXXXXXXXXXXXXXXXXXXXXXXXXXXXXXXXX
