----------------o--------------------------------------o----------------------------------------------------------------------------------------------
---------------------o---------------------------o------tto-------------tt---------------------o------------------------------------------------------
---------tt---tt------------------------------o----tt---tt--------------tt---o-o-----------tt--tt-----------------------------------------------------
------tt-tt---ttg------o----------g----------------tt---tt--------g-----tt--------o--------tttttt-----------------------------------------------------
------tt-tt--gtt%%------%%%%----%%%%%%%o-------g---tt-y-tt%%%%%%%%%%----ttg---%%%%G%%---%%otttttt-o%%%%%%%%-----------tt------------------------------
XXXXXXXXXXXXXXXXXXXXXXXXXXXXXXXXX||||||-----XXXXXXgtt-XXXXXXXXXXX|||o--XXXXXXXXXXXXXXXXXXXXXXXXXXXXXXXXXXX|--tt-----o-tt----------------%%%-----------
XXXXXXXXXXXXXXXXXXXXXXXXXXXXXXXXX||||||----gXXXXXXXXXXXXXXXXXXXXX|||---XXXXXXXXXXXXXXXXXXXXXXXXXXXXXXXXXXX|--tt-------tt----------%%%---|||--------o-o
XXXXXXXXXXXXXXXXXXXXXXXXXXXXXXXXX||||tt-%%%%XXXXXXXXXXXXXXXXXXXXXXXXXXXXXXXXXXXXXXXXXXXXXXXXXXXXXXXXXXXXXX|o-tt---G-G-tt----------|||---|||----o------
XXXXXXXXXXXXXXXXXXXXXXXXXXXXXXXXX||||tt-||||XXXXXXXXXXXXXXXXXXXXXXXXXXXXXXXXXXXXXXXXXXXXXXXXXXXXXXXXXXXXXX|-yttXXXXXXXXXXX---tt---|||---||tt----------
XXXXXXXXXXXXXXXXXXXXXXXXXXXXXXXXXXXXXXXXXXXXXXXXXXXXXXXXXXXXXXXXXXXXXXXXXXXXXXXXXXXXXXXXXXXXXXXXXXXXXXXXXXXXXXXXXXXXXXXXXX-%%tt%%tt||---||tt-tt-------
XXXXXXXXXXXXXXXXXXXXXXXXXXXXXXXXXXXXXXXXXXXXXXXXXXXXXXXXXXXXXXXXXXXXXXXXXXXXXXXXXXXXXXXXXXXXXXXXXXXXXXXXXXXXXXXXXXXXXXXXXXo||tt||tt||---||tt-ttggF-g--
XXXXXXXXXXXXXXXXXXXXXXXXXXXXXXXXXXXXXXXXXXXXXXXXXXXXXXXXXXXXXXXXXXXXXXXXXXXXXXXXXXXXXXXXXXXXXXXXXXXXXXXXXXXXXXXXXXXXXXXXXXXXXXXXXXXXXXXXXXXXXXXXXXXXXX
XXXXXXXXXXXXXXXXXXXXXXXXXXXXXXXXXXXXXXXXXXXXXXXXXXXXXXXXXXXXXXXXXXXXXXXXXXXXXXXXXXXXXXXXXXXXXXXXXXXXXXXXXXXXXXXXXXXXXXXXXXXXXXXXXXXXXXXXXXXXXXXXXXXXXX
XXXXXXXXXXXXXXXXXXXXXXXXXXXXXXXXXXXXXXXXXXXXXXXXXXXXXXXXXXXXXXXXXXXXXXXXXXXXXXXXXXXXXXXXXXXXXXXXXXXXXXXXXXXXXXXXXXXXXXXXXXXXXXXXXXXXXXXXXXXXXXXXXXXXXX
XXXXXXXXXXXXXXXXXXXXXXXXXXXXXXXXXXXXXXXXXXXXXXXXXXXXXXXXXXXXXXXXXXXXXXXXXXXXXXXXXXXXXXXXXXXXXXXXXXXXXXXXXXXXXXXXXXXXXXXXXXXXXXXXXXXXXXXXXXXXXXXXXXXXXX
XXXXXXXXXXXXXXXXXXXXXXXXXXXXXXXXXXXXXXXXXXXXXXXXXXXXXXXXXXXXXXXXXXXXXXXXXXXXXXXXXXXXXXXXXXXXXXXXXXXXXXXXXXXXXXXXXXXXXXXXXXXXXXXXXXXXXXXXXXXXXXXXXXXXXX
