------------------------------------------------------------------------------------------------------------------------------------------------------
------------------------------------------------------------------------------------------------------------------------------------------------------
------------------------------------------------------------------------------------------------------------------------------------------------------
------------------------------------------------------------------------------------------------------------------------------------------------------
------------------------------------------------------------------------------------------------------------------------------------------------------
-------------------------------------g-------------------------------------------------------------------------------------------------go-------------
-----------tt----------------------%%%%%-------%%%%----o-----------------Gg-G-g-g---------------------------------------------------%%%%%o----o---tt--
-----------tt------o--o------------|||||-o-tt--||||-----------------o--%%%%%%%%%%%--------------G-----------g-----------------------||||tt-o------tt--
-----------tt--o------G-------g----|||||--ott-o||||--o-----------------||||||tt|||----------%%%%%%---------%%%%---------------------||||tt--------tt-o
-----------tt-------%%%%%%%%%%%%%%%|||||---tt--||||--------------------||||||tt|||----------||||||---------||||---------------------||||tt-------Ftt--
XXXXXXXXXXXXXXXXXXX-||||||||||||||||||||---tt--||||-g-----go----%%%%%--||||||tt|||------tt--||||||----ooo--||||--%%%%%-----o--------|||XXXXXXXXXXXXXXX
XXXXXXXXXXXXXXXXXXX-||XX||||||||||||||||oXXXXXXXXXXXXXXXXXXXXXXXXXXXXXXXXXXXXXXXXX------tt--||||||o-tt-----||||--|||||---o----------|||XXXXXXXXXXXXXXX
XXXXXXXXXXXXXXXXXXXXXXXX||||||||||||||||-XXXXXXXXXXXXXXXXXXXXXXXXXXXXXXXXXXXXXXXXX------tt-XXXXXXXX-tt%----||||--|||||--------------|||XXXXXXXXXXXXXXX
XXXXXXXXXXXXXXXXXXXXXXXX||||||||||||||||-XXXXXXXXXXXXXXXXXXXXXXXXXXXXXXXXXXXXXXXXXXXXXXXXXXXXXXXXXXgtt|-g-o||||--|||||-gG--XXXXXXXXXXXXXXXXXXXXXXXXXXX
XXXXXXXXXXXXXXXXXXXXXXXXXXXXXXXXXXXXXXXXXXXXXXXXXXXXXXXXXXXXXXXXXXXXXXXXXXXXXXXXXXXXXXXXXXXXXXXXXXXXXXXXXXXXXXXXXXXXXXXXXXXXXXXXXXXXXXXXXXXXXXXXXXXXXX
XXXXXXXXXXXXXXXXXXXXXXXXXXXXXXXXXXXXXXXXXXXXXXXXXXXXXXXXXXXXXXXXXXXXXXXXXXXXXXXXXXXXXXXXXXXXXXXXXXXXXXXXXXXXXXXXXXXXXXXXXXXXXXXXXXXXXXXXXXXXXXXXXXXXXX
