------------------------------------------------------------------------------------------------------------------------------------------------------
------------------------------------------------------------------------------------------------------------------------------------------------------
-------------------------tt---------------------------------------------------------------------------------------------------------------------------
-----------oo------------tty--------------o--------------o------------------------------------------------------------------------------------G-------
------------------tt-----tt%%%%-%%-----%%-----tt---------tt---------------------------------------------------------------------------%%%----%%%%-----
------o--o-------gtt-Y---tt||||-XXXXXXXXXXXXX%tt%--------tt---------------------------------------------------------------------------|||----||||--o--
----------XXXXXXXXXXXXXXXXXXXXXXXXXXXXXXXXXXX|tt|--------tto--------------------------------------------------g-----------------------|||----||||-----
----------XXXXXXXXXXXXXXXXXXXXXXXXXXXXXXXXXXX|tt|-------otty---o%%o-----------------------------------------%%%%%---------------------|||----||||---tt
XXXXXXXXXXXXXXXXXXXXXXXXXXXXXXXXXXXXXXXXXXXXXXXXXXXXXXXXXXXX----||------------------------------------------|||||---------%%%%--------|||----||||---tt
XXXXXXXXXXXXXXXXXXXXXXXXXXXXXXXXXXXXXXXXXXXXXXXXXXXXXXXXXXXX----||-%%%%---------------------G---------------|||||---------||||--------|||----||||o--tt
XXXXXXXXXXXXXXXXXXXXXXXXXXXXXXXXXXXXXXXXXXXXXXXXXXXXXXXXXXXX----||-||||-%%%%--o---------%%%%%%%---tttt------|||||---------||||-------o|||-tt-||||-XXXX
XXXXXXXXXXXXXXXXXXXXXXXXXXXXXXXXXXXXXXXXXXXXXXXXXXXXXXXXXXXX----||g|tt|-||||------------|||||||---tttttto---|||||oo-------|||tt-tt----|||-tt-||||-XXXX
XXXXXXXXXXXXXXXXXXXXXXXXXXXXXXXXXXXXXXXXXXXXXXXXXXXXXXXXXXXXXXXXXXX|tt|-||||----ott-----|||||||---tttttt----|||||---------|||tt-tt----|||-tt-||||-XXXX
XXXXXXXXXXXXXXXXXXXXXXXXXXXXXXXXXXXXXXXXXXXXXXXXXXXXXXXXXXXXXXXXXXX|tt|-||||--Go-tt--g--|||||||---tttttt----|||||--------G|||ttGtt---g|||-tt-||||FXXXX
XXXXXXXXXXXXXXXXXXXXXXXXXXXXXXXXXXXXXXXXXXXXXXXXXXXXXXXXXXXXXXXXXXXXXXXXXXXXXXXXXXXXXXXXXXXXXXXXXXXXXXXXXXXXXXXXXXXXXXXXXXXXXXXXXXXXXXXXXXXXXXXXXXXXXX
XXXXXXXXXXXXXXXXXXXXXXXXXXXXXXXXXXXXXXXXXXXXXXXXXXXXXXXXXXXXXXXXXXXXXXXXXXXXXXXXXXXXXXXXXXXXXXXXXXXXXXXXXXXXXXXXXXXXXXXXXXXXXXXXXXXXXXXXXXXXXXXXXXXXXX
