-------------------------------o---------------------------------------------------------------------------------o-------------------o----------------
---------------tt--------------------------o-------------------------------------------------------tt----------tt---------------------o---o-------o---
-------------o-tt------------o---------------------o--------------------------tt-------------------tt-------tt-tt---------------o---o---o-------------
---------------tt----------------tt-------------o-----------------------------tt--------------o---ott-------tt-ttG--o----g----o-----tt--------o-------
---------------tto------oG-------ttG--G------Gg----tt%%-----------------------tt%-g---%%%-o----Gg--tt-------tt%tt%%G---%%%%%--------tty-------G--F---%
XXXXXXX------XXXXX------XXXXXXXXXXXXX%%%---XXXXXXXXtt||----------tt----------XXXXXXXXXXXXXXXXXXXXXXXXXXXXXXXXXXXXXXXXXXXXXXXXXXXXXXXXXXXXXXXXXXXXXXXXX
XXXXXXX------XXXXX------XXXXXXXXXXXXX|||---XXXXXXXXtt||----------tto-%%%%%%%%XXXXXXXXXXXXXXXXXXXXXXXXXXXXXXXXXXXXXXXXXXXXXXXXXXXXXXXXXXXXXXXXXXXXXXXXX
XXXXXXX------XXXXX------XXXXXXXXXXXXX|||---XXXXXXXXXX||----XXo---tt--||tt||||XXXXXXXXXXXXXXXXXXXXXXXXXXXXXXXXXXXXXXXXXXXXXXXXXXXXXXXXXXXXXXXXXXXXXXXXX
XXXXXXX------XXXXX------XXXXXXXXXXXXX|||---XXXXXXXXXX||----XX----tt--||tt||||XXXXXXXXXXXXXXXXXXXXXXXXXXXXXXXXXXXXXXXXXXXXXXXXXXXXXXXXXXXXXXXXXXXXXXXXX
XXXXXXX------XXXXX------XXXXXXXXXXXXX|||---XXXXXXXXXX||----XXXXXXXXXXXXXXXXXXXXXXXXXXXXXXXXXXXXXXXXXXXXXXXXXXXXXXXXXXXXXXXXXXXXXXXXXXXXXXXXXXXXXXXXXXX
XXXXXXX------XXXXX------XXXXXXXXXXXXX|||---XXXXXXXXXX||----XXXXXXXXXXXXXXXXXXXXXXXXXXXXXXXXXXXXXXXXXXXXXXXXXXXXXXXXXXXXXXXXXXXXXXXXXXXXXXXXXXXXXXXXXXX
XXXXXXX------XXXXX------XXXXXXXXXXXXX|||---XXXXXXXXXX||----XXXXXXXXXXXXXXXXXXXXXXXXXXXXXXXXXXXXXXXXXXXXXXXXXXXXXXXXXXXXXXXXXXXXXXXXXXXXXXXXXXXXXXXXXXX
XXXXXXX------XXXXX----ttXXXXXXXXXXXXX|||---XXXXXXXXXX||----XXXXXXXXXXXXXXXXXXXXXXXXXXXXXXXXXXXXXXXXXXXXXXXXXXXXXXXXXXXXXXXXXXXXXXXXXXXXXXXXXXXXXXXXXXX
XXXXXXX------XXXXX----ttXXXXXXXXXXXXX|||---XXXXXXXXXX||----XXXXXXXXXXXXXXXXXXXXXXXXXXXXXXXXXXXXXXXXXXXXXXXXXXXXXXXXXXXXXXXXXXXXXXXXXXXXXXXXXXXXXXXXXXX
XXXXXXX------XXXXX----ttXXXXXXXXXXXXX|||---XXXXXXXXXX||----XXXXXXXXXXXXXXXXXXXXXXXXXXXXXXXXXXXXXXXXXXXXXXXXXXXXXXXXXXXXXXXXXXXXXXXXXXXXXXXXXXXXXXXXXXX
XXXXXXX-oo---XXXXX---GttXXXXXXXXXXXXX|||-Y-XXXXXXXXXX||----XXXXXXXXXXXXXXXXXXXXXXXXXXXXXXXXXXXXXXXXXXXXXXXXXXXXXXXXXXXXXXXXXXXXXXXXXXXXXXXXXXXXXXXXXXX
