------------------------------------------------------------------------------------------------------------------------------------------------------
------------------------------------------------------------------------------------------------------------------------------------------------------
--------------------o---------------------------------------------------------------------------------------------------------------------------------
---------tt--------or---------------------------------------------------------------------------------------------------------------------------------
---------tt%%%--y%%%%%%%----------------------------------------------------------------------------------------%%------------------------------------
--------ott||XXXXXXXXX||--------------------------------------------o-------------------------------------------||------------------------------------
XXXXXXXXXXXXXXXXXXXXXX||---------------------------------------------------o-o----------------------------------||----r---r---------------------------
XXXXXXXXXXXXXXXXXXXXXX||-----------------------------tt------------------------tt-------------------------------||--%%%%%%%%-%%%----------------------
XXXXXXXXXXXXXXXXXXXXXX||-----------------o------tt---tt---------------o-------ott---------G---------------------||--||||||||-|||----------------------
XXXXXXXXXXXXXXXXXXXXXXXXXX-----------o--o-------tt--otty---------------o---R---tt-------%%%%-----------o--------||--||||||||-|||----------------------
XXXXXXXXXXXXXXXXXXXXXXXXXX-------------o-XXXXXXXXXXXXXXX------XXXXXXXXXXXXXXXXXXX-------||||-------o--tt--------||--||||||||tt||tto---------------tt--
XXXXXXXXXXXXXXXXXXXXXXXXXX---------------XXXXXXXXXXXXXXX------XXXXXXXXXXXXXXXXXXX--tt---||||----o-----tty-R-----|tt-||||||||tt||tt---------tt-----tt--
XXXXXXXXXXXXXXXXXXXXXXXXXX--------o------XXXXXXXXXXXXXXX--oo--XXXXXXXXXXXXXXXXXXX--tt---||||------%%%-tt%%%%%%--|tt-||||||||tt||tt------o-ott-tt--tt--
XXXXXXXXXXXXXXXXXXXXXXXXXXo-R----------K-XXXXXXXXXXXXXXX------XXXXXXXXXXXXXXXXXXX--tt---||||----y-|||-tt||||||XX|tt-||||||||tt||tt--o------tt-tt-Ftt--
XXXXXXXXXXXXXXXXXXXXXXXXXX--XXX----XXXXXXXXXXXXXXXXXXXXX----ttXXXXXXXXXXXXXXXXXXXXXXXXXXXXXXXXXXXXXXXXXXXX||||XXXXXXXX|||||XXXXXXXXXXXXXXXXXXXXXXXXXXo
XXXXXXXXXXXXXXXXXXXXXXXXXX--XXXo--GXXXXXXXXXXXXXXXXXXXXX%%--ttXXXXXXXXXXXXXXXXXXXXXXXXXXXXXXXXXXXXXXXXXXXX||||XXXXXXXX|||||XXXXXXXXXXXXXXXXXXXXXXXXXX-
