------------------------------------------------------------------------------------------------------------------------------------------------------
------------------------------------------------------------------------------------------------------------------------------------------------------
------------------------------------------------------------------------------------------------------------------------------------------------------
------------------------------------------------------------------------------------------------------------------------------------------------------
---------------------------------------------------------------------%%%--------------------------g---------------------------------------------------
---------------------------------------------------------------------|||-------------------------%%%--------------------------------------G-----------
----------------------%%---------------------%%%%%-------------------|||-o-----------------------|||--------------------------------y----%%%%%%%------
----------o-----------||%%%%%%%%%%------%%%%%|||||-------------------|||-------------------------|||-------------------------------%%%-%%|||||||------
----------------------||||||||||||------||||||||||-------------------|||---o---------------------|||-------------------------------|||-|||||||||------
------oo--------------||||||||||||------||||||||||----------o-----tt-|||---------------o-------o-|||----------------------o--------|||-|||||||||------
-------------y---o--G-|||||||||||tt-----||||||||||-----------o--G-tt-|||------XXXXX-----%%-------|||------------------tto--Y-------|||-||tt|||||------
XXXXXXXXXXXXXXXXXXXXXXXXXXXX|||||tt-----||||||||||--tt---XXXXXXXXXtt-|XXXXXXXXXXXXX-----||-------|||-tt---------tt-tt-tt--%%%--o---|||o||tt|||||------
XXXXXXXXXXXXXXXXXXXXXXXXXXXX|||||tt-----||||||||||--tt-ygXXXXXXXXXXXXXXXXXXXXXXXXXX-----||-------|||ott-----o---tt-tt-tt--|||------|||-||tt|||||---tt-
XXXXXXXXXXXXXXXXXXXXXXXXXXXX|||||ttXX-G-||||||||||--tt%%%XXXXXXXXXXXXXXXXXXXXXXXXXX-----||-G-----|||-tt------%%%tt-tt-tt--|||-----y|||-||tt|||||-F-tt-
XXXXXXXXXXXXXXXXXXXXXXXXXXXXXXXXXXXXXXXXXXXXXXXXXXXXXXXXXXXXXXXXXXXXXXXXXXXXXXXXXXXXXXXXXXXXXXXXXXXXXXXXXXXXXXXXXXXXXXXXXXXXXXXXXXXXXXXXXXXXXXXXXXXXXX
XXXXXXXXXXXXXXXXXXXXXXXXXXXXXXXXXXXXXXXXXXXXXXXXXXXXXXXXXXXXXXXXXXXXXXXXXXXXXXXXXXXXXXXXXXXXXXXXXXXXXXXXXXXXXXXXXXXXXXXXXXXXXXXXXXXXXXXXXXXXXXXXXXXXXX
