------------------------------------------------------------------------------------------------------------------------------------------------------
--------------------------------------------------------------------------------------------------------------------------------------------------o---
------------------------------------------------------------------------------------------------------------------------------------------------------
---------------------------------------------------------------------------------------------------------------------------------------------------o--
------------------------------------------------------------------------------------------------------------------------------------------------------
--------------------------------------------------------------------------------------------------------------------------------------------o----F--o-
--------------------------------------------------------------------------------------------%%-------------------------------------------------XXXXXXX
------------------------------------------------------o---o---------------------------------||-------------------------------------------------XXXXXXX
------------------------------------tt----------------tt------------------------------------||-------------------------------------------------XXXXXXX
-------------o-----------o--o-------tt------o---------tt-Y----------------------------------||---%%-------------------------o------------------XXXXXXX
----------o-o----------------o------tt--------o-------tt%%%------tt---------o-----------tt--||---||---tt--tt------------------tto----o----XXXXXXXXXXXX
-----------o--tt--Go----------G--o--tt---g---------o--tt|||----G-tt---------%%%-----%%--tto-||---||o--tt-ott-------------o---ott-------%%%XXXXXXXXXXXX
--------o-----tt--XXXXXXXXXXXXXXXXXXXXXXXXXXXXXXXXXXXXXXXXXXXXXXXtt------oXXX||-tttt||--tt--||-ott|---tttttt--------G---------tt-ott-tt|||XXXXXXXXXXXX
-------GG-----tt--XXXXXXXXXXXXXXXXXXXXXXXXXXXXXXXXXXXXXXXXXXXXXXXtt-------XXX||-tttt||--ttg-||--tt|---tttttt------G%%%%-------ttg-tt-tt|XXXXXXXXXXXXXX
XXXXXXXXXXXXXXXXXXXXXXXXXXXXXXXXXXXXXXXXXXXXXXXXXXXXXXXXXXXXXXXXXXXXXXXXXXXXXXXXXXXXXXXXXXXXXXXXXXXXXXXXXXXXXXXXXXXXXXXXXXXXXXXXXXXXXXXXXXXXXXXXXXXXXX
XXXXXXXXXXXXXXXXXXXXXXXXXXXXXXXXXXXXXXXXXXXXXXXXXXXXXXXXXXXXXXXXXXXXXXXXXXXXXXXXXXXXXXXXXXXXXXXXXXXXXXXXXXXXXXXXXXXXXXXXXXXXXXXXXXXXXXXXXXXXXXXXXXXXXX
