------------------------------------------------------------------------------------------------------------------------------------------------------
------------------------------------------------------------------------------------------------------------------------------------o-----------------
-----------------------------------------------------------------------------------------------------------------tt----------------tt-------o---------
--------o--------------------------------------------------------------------------------------------------o-----tt------o----tt---tt-------------o---
-----tt--tt--o----------------------------------------------------------%%%%%%%---------------------------g------tt---------%%tto--tttt---o-----------
-----tt--tt--yG--yG----------G------------------------------------------|||||||--------------------tt----%%XXXXXXXXXXXXXXXXXXXXXXXXXXtt------o---tt---
-----tt--tt%%%%%%%%%%%----o%%%%%%----------o------------%%----------o---|||||||----------o---------tttt--||XXXXXXXXXXXXXXXXXXXXXXXXXXttY---G-----Ft---
-----tt-Gtt|||||||tt||tt---||||||-----------------o-----||---------ott-o|||||||--------------------tttt--||XXXXXXXXXXXXXXXXXXXXXXXXXXXXXXXXXXXXXXXXXXX
XXXXXXXXXXXXXXX|||tt||tt---||||||----o----o-------------||----------tt--|||||||---------------YXXXXXXXXXXXXXXXXXXXXXXXXXXXXXXXXXXXXXXXXXXXXXXXXXXXXXXX
XXXXXXXXXXXXXXXtt|tt||tttt-||||||--------tt-------------||-o-----XXXXXXXXX|||||------------tt%%XXXXXXXXXXXXXXXXXXXXXXXXXXXXXXXXXXXXXXXXXXXXXXXXXXXXXXX
XXXXXXXXXXXXXXXtt|tt||tttt-||||||-G-----gttY-XXXXXX-----||-------XXXXXXXXX|||||---tt-------tt||XXXXXXXXXXXXXXXXXXXXXXXXXXXXXXXXXXXXXXXXXXXXXXXXXXXXXXX
XXXXXXXXXXXXXXXXXXXXXXXXXXXXXXXXXXXXXXXXXXXXXXXXXXX-----|tt------XXXXXXXXX|||||---ttXXXXXXXXXXXXXXXXXXXXXXXXXXXXXXXXXXXXXXXXXXXXXXXXXXXXXXXXXXXXXXXXXX
XXXXXXXXXXXXXXXXXXXXXXXXXXXXXXXXXXXXXXXXXXXXXXXXXXX--G--|tt---oG-XXXXXXXXX|||||GGgttXXXXXXXXXXXXXXXXXXXXXXXXXXXXXXXXXXXXXXXXXXXXXXXXXXXXXXXXXXXXXXXXXX
XXXXXXXXXXXXXXXXXXXXXXXXXXXXXXXXXXXXXXXXXXXXXXXXXXXXXXXXXXXXXXXXXXXXXXXXXXXXXXXXXXXXXXXXXXXXXXXXXXXXXXXXXXXXXXXXXXXXXXXXXXXXXXXXXXXXXXXXXXXXXXXXXXXXXX
XXXXXXXXXXXXXXXXXXXXXXXXXXXXXXXXXXXXXXXXXXXXXXXXXXXXXXXXXXXXXXXXXXXXXXXXXXXXXXXXXXXXXXXXXXXXXXXXXXXXXXXXXXXXXXXXXXXXXXXXXXXXXXXXXXXXXXXXXXXXXXXXXXXXXX
XXXXXXXXXXXXXXXXXXXXXXXXXXXXXXXXXXXXXXXXXXXXXXXXXXXXXXXXXXXXXXXXXXXXXXXXXXXXXXXXXXXXXXXXXXXXXXXXXXXXXXXXXXXXXXXXXXXXXXXXXXXXXXXXXXXXXXXXXXXXXXXXXXXXXX
