------------------------------------------------------------------------------------------------------------------------------------------------------
------------------------------------------------------------------------------------------------------------------------------------o-----------------
--------------------------------------------------------------------------------------------------------------------------------o---------tt----------
--------------------------------------------------------------------------------------------y-----------------------------------------gg-ott-------g--
-----------------------------------------------------------------------------------------%%%%%---------------------------------------%%%%-tt-----F%%%-
-----------------------------------------------------------------------------------------|||||---------------G---------------o---%%%%||||-tt---oXXXXX-
----------------g------------------------------------------------------------------------|||||--%%---------%%%%------------o----XXXXXXXXXXXXXXXXXXXXX-
---------------%%%%%%%%%-----------------------------------------------------------------|||||--||---------||||---------%%%-----XXXXXXXXXXXXXXXXXXXXXG
---------------|||||||||------------------------------------------------tt----G----------|||||--||---------||||---------|||-----XXXXXXXXXXXXXXXXXXXXXX
-------------tt|||||||||------------------------------------o----o-o-o--tt--%%%%%-----%%%|||||--||-------o-||||----o----|||%%GY-XXXXXXXXXXXXXXXXXXXXXX
--------tt---tt|||||||||-----ggg--tt------------------o-----------------tt--|||||-tt--||||||||--tt---tt----||||tt-------|XXXXXXXXXXXXXXXXXXXXXXXXXXXXX
--------tt---tt|||tttt||---%tt%%%%tt------------------%%%------%%%%%%---tt--|||||-tt--||||||||--tt---tto---||||tt---o---|XXXXXXXXXXXXXXXXXXXXXXXXXXXXX
-------ott-G-tt|||tttt||---|tt||||tt---------oo-------|||------||tt||--XXXXXX||tt-tt-o||||||tt--tttt-tt----||||tt--%%---|XXXXXXXXXXXXXXXXXXXXXXXXXXXXX
XXXXXXXXXXXXXXXXXXXXXXXX--g|tt||||tt----------G-----G-|||-g-g--||tt||--XXXXXX||tt-tt--||||||tt--ttttgtt----||||tt--||---|XXXXXXXXXXXXXXXXXXXXXXXXXXXXX
XXXXXXXXXXXXXXXXXXXXXXXXXXXXXXXXXXXXXXXXXXXXXXXXXXXXXXXXXXXXXXXXXXXXXXXXXXXXXXXXXXXXXXXXXXXXXXXXXXXXXXXXXXXXXXXXXXXXXXXXXXXXXXXXXXXXXXXXXXXXXXXXXXXXXX
XXXXXXXXXXXXXXXXXXXXXXXXXXXXXXXXXXXXXXXXXXXXXXXXXXXXXXXXXXXXXXXXXXXXXXXXXXXXXXXXXXXXXXXXXXXXXXXXXXXXXXXXXXXXXXXXXXXXXXXXXXXXXXXXXXXXXXXXXXXXXXXXXXXXXX
