-------------------------------o-----o---o------------------------------------------------------------------------------------------------------------
------------------------------------o----tt-----------------------------------------------------------------------------------------------------------
------------------------------o----------tt-----------------------------------------------------------------------------------------------------------
-------------------------o--------oo-----ttg-----------------g---------------------------------------------y------------------------------------------
-------------------------%%-----o--g-%%%%tt%%o---o---------tt%%----------------------gGo---------o--------%%%%-------------------------G--------------
-------------------------||-%XXXXXXXXXXXXXXXXX--------tt---tt||------o%%-tt%%%%%%%%%%%%%------------------||||-------------------%%%%%%%%-------------
-------------------------XXXXXXXXXXXXXXXXXXXXX%%---o-ott---tt||-------||-tttt|||||||||||o----------tt-----||||-------------------||||||||-%%%%----o---
------------o---------XXXXXXXXXXXXXXXXXXXXXXXX||------tt---tt||--tt--tt|-tttt|||||||||||------o----tt-----||||---o---------------||||||||o||||-----o--
------o---------------XXXXXXXXXXXXXXXXXXXXXXXXXXXXXXXXXXXXXXXXX--tto-tt|-tttt|||||||||||-----o-----tt-----||||----tt---------%%--||||||||-||||-tt-----
--------tt----------ttXXXXXXXXXXXXXXXXXXXXXXXXXXXXXXXXXXXXXXXXXXXXXXXXXXXXXXXXXXXXXXXXXXXXXXXXXXXXXXXX----||||----tt---------||-o||||||||-||||-tt-----
--------tt----------ttXXXXXXXXXXXXXXXXXXXXXXXXXXXXXXXXXXXXXXXXXXXXXXXXXXXXXXXXXXXXXXXXXXXXXXXXXXXXXXXX---o||||o---tt---------||--||||||||-||||-ttF----
XXXXXXXXXXXXXXXXXXXXXXXXXXXXXXXXXXXXXXXXXXXXXXXXXXXXXXXXXXXXXXXXXXXXXXXXXXXXXXXXXXXXXXXXXXXXXXXXXXXXXX----||||----tt---------||--||XXXXXXXXXXXXXXXXXX-
XXXXXXXXXXXXXXXXXXXXXXXXXXXXXXXXXXXXXXXXXXXXXXXXXXXXXXXXXXXXXXXXXXXXXXXXXXXXXXXXXXXXXXXXXXXXXXXXXXXXXX-o--|||XXXXXXX------tt-||--||XXXXXXXXXXXXXXXXXX-
XXXXXXXXXXXXXXXXXXXXXXXXXXXXXXXXXXXXXXXXXXXXXXXXXXXXXXXXXXXXXXXXXXXXXXXXXXXXXXXXXXXXXXXXXXXXXXXXXXXXXXXXXXXXXXXXXXXX%%%%--tt-||--||XXXXXXXXXXXXXXXXXXG
XXXXXXXXXXXXXXXXXXXXXXXXXXXXXXXXXXXXXXXXXXXXXXXXXXXXXXXXXXXXXXXXXXXXXXXXXXXXXXXXXXXXXXXXXXXXXXXXXXXXXXXXXXXXXXXXXXXXXXXXXXXXXXXXXXXXXXXXXXXXXXXXXXXXXX
XXXXXXXXXXXXXXXXXXXXXXXXXXXXXXXXXXXXXXXXXXXXXXXXXXXXXXXXXXXXXXXXXXXXXXXXXXXXXXXXXXXXXXXXXXXXXXXXXXXXXXXXXXXXXXXXXXXXXXXXXXXXXXXXXXXXXXXXXXXXXXXXXXXXXX
