------------------------------------------------------------------------------------------------------------------------------------------------------
--------------------------------------------------------o----oo---------------------------------------------------------------------------------------
---------------------------------------------------------o------o-------------------------------------------------------------------------------------
-----------------------------------------------------------Y----------------GYG-YG------o---o---------------------------------------------------------
-------------------------------------------------%%%-----%%%%%----g--y--Go%%%%%%%%%----------------o--------------------------------------------------
----------------------------------------%%%%%%---||XXXXXXXXXXXXXX%%%%%%-XXXXXXXXX||----%%o------------------------------------------------------------
----------------------------------------||||||---||XXXXXXXXXXXXXX||||||-XXXXXXXXX||---o||--tto--------------------------------------------------------
--------o-------------------------------||||||XXXXXXXXXXXXXXXXXXX||||||-XXXXXXXXX||----||--tt-----------------------------------------%%--------------
----------------------------------------XXXXXXXXXXXXXXXXXXXXXXXXXXXXXXXXXXXXXXXXXXXXXXXXXXXXXXXXXXXX----------tt-----------g---G------||--------------
----------------------------------------XXXXXXXXXXXXXXXXXXXXXXXXXXXXXXXXXXXXXXXXXXXXXXXXXXXXXXXXXXXXXX--------tt---o--%%%%%%%%%%%-----||--%%----------
------o-------oo---o----------------o---XXXXXXXXXXXXXXXXXXXXXXXXXXXXXXXXXXXXXXXXXXXXXXXXXXXXXXXXXXXXXX-------ottg-----||||||tt|||---tt||--||----------
-----------tt---tto-----%%%--tt--------yXXXXXXXXXXXXXXXXXXXXXXXXXXXXXXXXXXXXXXXXXXXXXXXXXXXXXXXXXXXXXXXXXXXXXXXXXXXXX-||||||tt|||---tt||--||----------
XXXXXXXXXXXtt---tt------|||--tt-----XXXXXXXXXXXXXXXXXXXXXXXXXXXXXXXXXXXXXXXXXXXXXXXXXXXXXXXXXXXXXXXXXXXXXXXXXXXXXXXXXtt|||||tt|||---tt||--||----------
XXXXXXXXXXXtt---ttXXX-g-|||--tt-Y-o-XXXXXXXXXXXXXXXXXXXXXXXXXXXXXXXXXXXXXXXXXXXXXXXXXXXXXXXXXXXXXXXXXXXXXXXXXXXXXXXXXtt|||||tt|||-%%tt||--||-----Fy--g
XXXXXXXXXXXXXXXXXXXXXXXXXXXXXXXXXXXXXXXXXXXXXXXXXXXXXXXXXXXXXXXXXXXXXXXXXXXXXXXXXXXXXXXXXXXXXXXXXXXXXXXXXXXXXXXXXXXXXXXXXXXXXXXXXXXXXXXXXXXXXXXXXXXXXX
XXXXXXXXXXXXXXXXXXXXXXXXXXXXXXXXXXXXXXXXXXXXXXXXXXXXXXXXXXXXXXXXXXXXXXXXXXXXXXXXXXXXXXXXXXXXXXXXXXXXXXXXXXXXXXXXXXXXXXXXXXXXXXXXXXXXXXXXXXXXXXXXXXXXXX
