---------------------------------------------------------------------------------------------------------------------------o-----o--------------------
-----------------------------------------------------------------------------------------------------------------------------------o----o-------------
-------------------------------------------------------------------------------------------------------------------o------------o-tt-----o------o-----
------------------------------------------------------------------------------------------------------tt--------------------tt----tt------------------
-----------------------------------------------------------------------------------------------------%tt-------tt%%---------tt%%--tt------------------
------------------------------------------------------------------------------------------o-----Ygtt-|tt---o---tt||----XXXXXXXXXXXXXX---------o-%F%%%-
---------o----------------------------------------------------------------------------------G-%%%%tt-|ttogY----tt||----XXXXXXXXXXXXXXXXXXXXXXXXXXXXXXX
------------------------------------------------------------------------------------------XXXXXXXXXXXXXXXXXXXXXXXXXXXXXXXXXXXXXXXXXXXXXXXXXXXXXXXXXXXX
----------------o---%%%%-----------------------------------------------------------o-tt---XXXXXXXXXXXXXXXXXXXXXXXXXXXXXXXXXXXXXXXXXXXXXXXXXXXXXXXXXXXX
XXXXXXXXXX----------||||---------------------------tt--------------------------------tt%%%XXXXXXXXXXXXXXXXXXXXXXXXXXXXXXXXXXXXXXXXXXXXXXXXXXXXXXXXXXXX
XXXXXXXXXX---------tt|||o-----o-----oo------o------tt-----------tt-------------------tt|||XXXXXXXXXXXXXXXXXXXXXXXXXXXXXXXXXXXXXXXXXXXXXXXXXXXXXXXXXXXX
XXXXXXXXXX----o----tt|tt----o-----------o----------tt-----------tt----o--o----------gtt|XXXXXXXXXXXXXXXXXXXXXXXXXXXXXXXXXXXXXXXXXXXXXXXXXXXXXXXXXXXXXX
XXXXXXXXXX---o---o-tt|tt--G------------------------tt----G------tt-----o-----tt----XXXXXXXXXXXXXXXXXXXXXXXXXXXXXXXXXXXXXXXXXXXXXXXXXXXXXXXXXXXXXXXXXXX
XXXXXXXXXXXXXXXXXXXXXXXXXXXXXXXXo-Yo--------XXXXXXXXXXXXXXXXXXXXtt--o------o-tt----XXXXXXXXXXXXXXXXXXXXXXXXXXXXXXXXXXXXXXXXXXXXXXXXXXXXXXXXXXXXXXXXXXX
XXXXXXXXXXXXXXXXXXXXXXXXXXXXXXXXXXXXXXXXXXXXXXXXXXXXXXXXXXXXXXXXXXXXXXXXXXXXXXXXXXXXXXXXXXXXXXXXXXXXXXXXXXXXXXXXXXXXXXXXXXXXXXXXXXXXXXXXXXXXXXXXXXXXXX
XXXXXXXXXXXXXXXXXXXXXXXXXXXXXXXXXXXXXXXXXXXXXXXXXXXXXXXXXXXXXXXXXXXXXXXXXXXXXXXXXXXXXXXXXXXXXXXXXXXXXXXXXXXXXXXXXXXXXXXXXXXXXXXXXXXXXXXXXXXXXXXXXXXXXX
