---------------------------------------------------oo--------o----------------------------------------------------------------------------------------
-----------------------------------------------------tt----ott----------------------------------------------------------------------------------------
-----------------------------------------------------tt-----tt----------------------------------------------------------------------------------------
-------------o-------------------------tt------------tt-tt--tttt---------------------------------------------G-g--------------------------------------
-------------yo-----------------------%tt%-----------tt-tt--tttt-----------------------------%%%%----------%%%%%%---------%%--------------------------
XXXXXXXXXXXXXX-----------------------g|tt|-g-------XXXXXXXXXXXXX------------------------o----||||---------tt|||||---------||-------%%---------Y-------
XXXXXXXXXXXXXX------------------XXXXXXXXXXXXX-o--XXXXXXXXXXXXXXX-------o-------------------tt||||---------tt|||||tt%%%%%%%||-------||------%%%%%%%%%--
XXXXXXXXXXXXXX-------o----------XXXXXXXXXXXXX----XXXXXXXXXXXXXXX-------------------o----tt-tt||tt---------tt|||||tt|||||||||-------||------|||||||||--
XXXXXXXXXXXXXX------------------XXXXXXXXXXXXX---gXXXXXXXXXXXXXXXXXXX----o---------------tt-tt||tt------XXXXXXXXXXXXXXXXXX|||----o-tt|------|||||||||--
XXXXXXXXXXXXXXXXXXXXXXXXXXXXXXXXXXXXXXXXXXXXXXXXXXXXXXXXXXXXXXXXXXXX--------G---o-----gGtt-tt||tt----o-XXXXXXXXXXXXXXXXXX|||------tt|---o--|||||||||--
XXXXXXXXXXXXXXXXXXXXXXXXXXXXXXXXXXXXXXXXXXXXXXXXXXXXXXXXXXXXXXXXXXXXXXXXXXXXXXXXXXXXXXXXXXXXXXXXXXXXXXXXXXXXXXXXXXXXXXXXX|||------tttt---o-tt|||||||--
XXXXXXXXXXXXXXXXXXXXXXXXXXXXXXXXXXXXXXXXXXXXXXXXXXXXXXXXXXXXXXXXXXXXXXXXXXXXXXXXXXXXXXXXXXXXXXXXXXXXXXXXXXXXXXXXXXXXXXXXX|||---g--tttt-----tt|||||||-X
XXXXXXXXXXXXXXXXXXXXXXXXXXXXXXXXXXXXXXXXXXXXXXXXXXXXXXXXXXXXXXXXXXXXXXXXXXXXXXXXXXXXXXXXXXXXXXXXXXXXXXXXXXXXXXXXXXXXXXXXXXXXXXXXXXXXtt----gtt||||F||-X
XXXXXXXXXXXXXXXXXXXXXXXXXXXXXXXXXXXXXXXXXXXXXXXXXXXXXXXXXXXXXXXXXXXXXXXXXXXXXXXXXXXXXXXXXXXXXXXXXXXXXXXXXXXXXXXXXXXXXXXXXXXXXXXXXXXXXXXXXXXXXXXXXXXXXX
XXXXXXXXXXXXXXXXXXXXXXXXXXXXXXXXXXXXXXXXXXXXXXXXXXXXXXXXXXXXXXXXXXXXXXXXXXXXXXXXXXXXXXXXXXXXXXXXXXXXXXXXXXXXXXXXXXXXXXXXXXXXXXXXXXXXXXXXXXXXXXXXXXXXXX
XXXXXXXXXXXXXXXXXXXXXXXXXXXXXXXXXXXXXXXXXXXXXXXXXXXXXXXXXXXXXXXXXXXXXXXXXXXXXXXXXXXXXXXXXXXXXXXXXXXXXXXXXXXXXXXXXXXXXXXXXXXXXXXXXXXXXXXXXXXXXXXXXXXXXX
