------------------------------------------------------------------------------------------------------------------------------------------------------
------------------------------------------------------------------------------------------------------------------------------------------------------
------------------------------------------------------------------------------------------------------------------------------------------------------
---------------------------------------------------------------------------------------------------------------------------------o----tt--o-----o-----
----------------------------------------%%%-------------------------------------------------------------------------------------------tt--------------
----------------------------------------|||-----------------------------------------------------------------------------------o-------tt-%%------gy---
----------------------------------------|||-----------------------------------------------------------------------------------------G-tt-||---%%%%%%%%
-----tt---------------------------------|||----------------------------------------------------Y---------------------o-----------XXXXXXXXXXX--||||tt||
-----tt---------------------------------|||---------o-----o------G---------------%%%o-------%%%%%%%---------------------%%-tt----XXXXXXXXXXXXXXXX|tt||
-----tt---------------------------------|||----o----------------%%%---tt---------|||--------|||||||--o---o--------------||-ttXXXXXXXXXXXXXXXXXXXXFtt||
-----tt-------------------tt--------tt--|||-----o---------------|||---tt--------tt||-o------|||||tt------------o--------||-ttXXXXXXXXXXXXXXXXXXXXXXXXX
XXXXXXXX--------o---------tt-o------tt--||tt---g-----------o----|||---tt--------tt||--------|||||tt-tt------o-o-og------|XXXXXXXXXXXXXXXXXXXXXXXXXXXXX
XXXXXXXX---o--tt-----tt-tttt--------tt--||tt---XXXXX---g----%%-G|||G--tt--%%----tt||--gG----|||||tt-tt-----------XXXXXXXXXXXXXXXXXXXXXXXXXXXXXXXXXXXXX
XXXXXXXX--o---tt-----tt-tttt--o%%--Gttgg||tt---XXXXXXXXXXXXXXXXXXXXXXXXXXXXXXXXXXXXXXXXXXXXXXXXXXXX-tt--o------g-XXXXXXXXXXXXXXXXXXXXXXXXXXXXXXXXXXXXX
XXXXXXXXXXXXXXXXXXXXXXXXXXXXXXXXXXXXXXXXXXXXXXXXXXXXXXXXXXXXXXXXXXXXXXXXXXXXXXXXXXXXXXXXXXXXXXXXXXXXXXXXXXXXXXXXXXXXXXXXXXXXXXXXXXXXXXXXXXXXXXXXXXXXXX
XXXXXXXXXXXXXXXXXXXXXXXXXXXXXXXXXXXXXXXXXXXXXXXXXXXXXXXXXXXXXXXXXXXXXXXXXXXXXXXXXXXXXXXXXXXXXXXXXXXXXXXXXXXXXXXXXXXXXXXXXXXXXXXXXXXXXXXXXXXXXXXXXXXXXX
