------------------------------------------------------------------------------------------------------------------------------------------------------
--------------------------------------------------------------------------o------------------------o--------------------------------------------------
----------------------------------------------------------------------o-------------tt-----o----------------------------------------------------------
---------tt-GG--G-----------------------------------------------------------o-------ttGGG---------o-o-------------------------------------------------
---------tt%%%%%%%------o--------------------------%%%%%----------------------tt----tt%%%%---tt%%%%--o-------------------------------o----GG----------
XXXXXXXXXXXXX|||tt---------------------------------|||||---------------G---o--tt----tt||||--GttXXXXXX----o---o-------tt------------ggg-%%%%%%%--------
XXXXXXXXXXXXX|||tt-------------%%------------------|||||------------XXXXXXXXXXXXXXXXXXXXXXXXXXXXXXXXX-------o--------tt--------o-%%%%%%|||||||--------
XXXXXXXXXXXXX|||tt-------------||--G---------------||tt|------------XXXXXXXXXXXXXXXXXXXXXXXXXXXXXXXXX----------------tt----------|||||||||||||-tt---o-
XXXXXXXXXXXXX|||tt-----G--%%---||%%%%%%------------||tt|--------o---XXXXXXXXXXXXXXXXXXXXXXXXXXXXXXXXX----------------ttg--------Y|||||||||||||-ttF----
XXXXXXXXXXXXXXXXXXXXXXXXXXXXX--||||||||------------||tt|%%-------o--XXXXXXXXXXXXXXXXXXXXXXXXXXXXXXXXXXXXXXXXXXXXXXXXXXXXXXXXXXXXXXXXXXXXXXXXXXXXXXXXXX
XXXXXXXXXXXXXXXXXXXXXXXXXXXXX-y||||||||--tt-------o||tt|||g--oYXXXXXXXXXXXXXXXXXXXXXXXXXXXXXXXXXXXXXXXXXXXXXXXXXXXXXXXXXXXXXXXXXXXXXXXXXXXXXXXXXXXXXXX
XXXXXXXXXXXXXXXXXXXXXXXXXXXXXXXX|||||||--tt-o------|XXXXXXXXXXXXXXXXXXXXXXXXXXXXXXXXXXXXXXXXXXXXXXXXXXXXXXXXXXXXXXXXXXXXXXXXXXXXXXXXXXXXXXXXXXXXXXXXXX
XXXXXXXXXXXXXXXXXXXXXXXXXXXXXXXX|||||||--tt--------|XXXXXXXXXXXXXXXXXXXXXXXXXXXXXXXXXXXXXXXXXXXXXXXXXXXXXXXXXXXXXXXXXXXXXXXXXXXXXXXXXXXXXXXXXXXXXXXXXX
XXXXXXXXXXXXXXXXXXXXXXXXXXXXXXXX|||||||--tt--Y--g--|XXXXXXXXXXXXXXXXXXXXXXXXXXXXXXXXXXXXXXXXXXXXXXXXXXXXXXXXXXXXXXXXXXXXXXXXXXXXXXXXXXXXXXXXXXXXXXXXXX
XXXXXXXXXXXXXXXXXXXXXXXXXXXXXXXXXXXXXXXXXXXXXXXXXXXXXXXXXXXXXXXXXXXXXXXXXXXXXXXXXXXXXXXXXXXXXXXXXXXXXXXXXXXXXXXXXXXXXXXXXXXXXXXXXXXXXXXXXXXXXXXXXXXXXX
XXXXXXXXXXXXXXXXXXXXXXXXXXXXXXXXXXXXXXXXXXXXXXXXXXXXXXXXXXXXXXXXXXXXXXXXXXXXXXXXXXXXXXXXXXXXXXXXXXXXXXXXXXXXXXXXXXXXXXXXXXXXXXXXXXXXXXXXXXXXXXXXXXXXXX
