------------------------------------------------------------------------------------------------------------------------------------------------------
------------------------------------------------------------------------------------------------------------------------------------------------------
------------------------------------------------------------------------------------------------------------------------------------------------------
----------------------------------------------------g-tt----------------------------------------------------------------------------------------------
---------------------------------------------------%%%tt------o---------------------------------------------------------------------------------------
---------------------------------------------------|||tt--------------o-------o-----------------------------------------------------------------------
---------------------------------------------------|||tt-G----------G----------tt-----------------------------------------------------o---------------
----------------tt-------------g-------------------||XXXXXXXXXXXXXXXXXXXXX--gg-tt----G------------%%%%%%--%%---g--------------------------------------
----------------tt-------tt--%%%%%%%%--o-----------||XXXXXXXXXXXXXXXXXXXXX-%%%%tt%%%%%%%---%tt----||||||--||--%%%-------------------------o-tt-------G
-------tt--tt---tt----o--tt-o||||||||---------tt---||XXXXXXXXXXXXXXXXXXXXXXXXXXXXX||||||---|tt----||||||tt||--|||-------------------o-------tt---F-oXX
-------tt--tt---tt-Y----gtt-Y||||||||----o----tt---||XXXXXXXXXXXXXXXXXXXXXXXXXXXXXXXXXXXXXXXtt----|tt|||tt||--|||---------------tt----------tt-XXXXXXX
XXXXXXXXX--tt--XXXXXXXXXXXXXXXXX|||||---------tt--XXXXXXXXXXXXXXXXXXXXXXXXXXXXXXXXXXXXXXXXXXXX--tt|tt|tttt||--|||---------------tt---XXXXXXXXXXXXXXXXX
XXXXXXXXX--ttg-XXXXXXXXXXXXXXXXX|||||-----g---tt--XXXXXXXXXXXXXXXXXXXXXXXXXXXXXXXXXXXXXXXXXXXX--tt|tt|tttt||--|||------------o--tt---XXXXXXXXXXXXXXXXX
XXXXXXXXXXXXXXXXXXXXXXXXXXXXXXXXXXXXXXXXXXXXXXXXXXXXXXXXXXXXXXXXXXXXXXXXXXXXXXXXXXXXXXXXXXXXXXXXXXXXXXXXXXXX-o|||----g--o-G-----tt---XXXXXXXXXXXXXXXXX
XXXXXXXXXXXXXXXXXXXXXXXXXXXXXXXXXXXXXXXXXXXXXXXXXXXXXXXXXXXXXXXXXXXXXXXXXXXXXXXXXXXXXXXXXXXXXXXXXXXXXXXXXXXXXXXXXXXXXXXXXXXXXXXXXXXXXXXXXXXXXXXXXXXXXX
XXXXXXXXXXXXXXXXXXXXXXXXXXXXXXXXXXXXXXXXXXXXXXXXXXXXXXXXXXXXXXXXXXXXXXXXXXXXXXXXXXXXXXXXXXXXXXXXXXXXXXXXXXXXXXXXXXXXXXXXXXXXXXXXXXXXXXXXXXXXXXXXXXXXXX
