------------------------------------------------------------------------------------------------------------------------------------------------------
------------------------------------------------------------------------------------------------------------------------------------------------------
------------------------------------------------------------------------------------------------------------------------------------------------------
------------------------------------------------------------------------------------------------------------------------------------------------------
---------------------------------------------------------------------------------------------------------------------------------%%%------------------
-----------------------------------------------------------------------o----------tt-g-----%tt---o----------------------%%-------|||------------------
--------------------------o--------------------------------------------tt------tt-tt%%%----|ttoo---o-o------------------||-------|||-------ggY-g-----Y
---------------Y----Y--%%%%%o-----------------------------------%%%%%%%tt------tt-tt|||--XXXXXXXXXXXXXXXXX-tt----tt-----||--o----|||------%%%%%%%%%%%%
-------------%%%%%tt%tt|||||-----tt-----------------------------|||||||tt--%%%-tt-tt|||--XXXXXXXXXXXXXXXXX-tt----tt---o-||-------|||------||||||||||||
-------------|||||tt|tt|||||--o--tt------------------o----------||||XXXXXXXXXXXXXXXX|||--XXXXXXXXXXXXXXXXX-tt----tt-----||-------|||------||||||||||||
----------XXXXXXXXXXXXXXXXX|--G--tt--------------------o--------||||XXXXXXXXXXXXXXXXXXXXXXXXXXXXXXXXXXXXXXYtt--y-tt-----||o------|||------||||||||||||
----------XXXXXXXXXXXXXXXXXXXXXXXXXXgo-G-----------g---------tt-||||XXXXXXXXXXXXXXXXXXXXXXXXXXXXXXXXXXXXXXXXXXXXXXXXXXXXXXXXXXXXXXX|---o--||||||||||||
----------XXXXXXXXXXXXXXXXXXXXXXXXXXXXXXXXXXXXXXXXXX----o-o--tto||||XXXXXXXXXXXXXXXXXXXXXXXXXXXXXXXXXXXXXXXXXXXXXXXXXXXXXXXXXXXXXXXXX---tt||||||||||||
----------XXXXXXXXXXXXXXXXXXXXXXXXXXXXXXXXXXXXXXXXXX---------tt-||XXXXXXXXXXXXXXXXXXXXXXXXXXXXXXXXXXXXXXXXXXXXXXXXXXXXXXXXXXXXXXXXXXX---tt|||||||F||||
XXXXXXXXXXXXXXXXXXXXXXXXXXXXXXXXXXXXXXXXXXXXXXXXXXXXXXXXXXXXXXXXXXXXXXXXXXXXXXXXXXXXXXXXXXXXXXXXXXXXXXXXXXXXXXXXXXXXXXXXXXXXXXXXXXXXXXXXXXXXXXXXXXXXXX
XXXXXXXXXXXXXXXXXXXXXXXXXXXXXXXXXXXXXXXXXXXXXXXXXXXXXXXXXXXXXXXXXXXXXXXXXXXXXXXXXXXXXXXXXXXXXXXXXXXXXXXXXXXXXXXXXXXXXXXXXXXXXXXXXXXXXXXXXXXXXXXXXXXXXX
