------------------------------------------------------------------------------------------------------------------------------------------------------
-------------------------------------------------------o----------------------------------------------------------------------------------------------
---------------------------------------------------------o--o-------------------------------------------------------------------------------------o---
--------------------------------------------------------------tt----o---------------------------------------------------------------------------------
--------------------------------------------%%---%%%o--y--o---tt%-----tt-----------------------------------------------------%%%%---------------------
--------------------------------------------||---|||--XXXXXXXXXXXXXXX-tt-------------------o---------------------------------||||------%%-------o-----
--------------------------------------o-----||---XXXXXXXXXXXXXXXXXXXX-tt--oo-------------------------------------------------||||------|tt--tt---F----
----------------%%%%--------------------tt-o||---XXXXXXXXXXXXXXXXXXXXXXXXXX--------------------------------------------------||||------|tt-ott---XX---
----------------||||--------------------tto-||---XXXXXXXXXXXXXXXXXXXXXXXXXX---------o----------------------------------------||||o---o-|tt--tt---XX---
---------------o||||----o--------------XXXXXXXXXXXXXXXXXXXXXXXXXXXXXXXXXXXX---------------g-gg------o------------------------||||--G---|tt--tty--XX---
----------------||||------------------gXXXXXXXXXXXXXXXXXXXXXXXXXXXXXXXXXXXX--------------XXXXXXXX-------%%%------------tt----||||--XXXXXXXXXXXXXXXX--G
-------------G--||||-g--------------XXXXXXXXXXXXXXXXXXXXXXXXXXXXXXXXXXXXXXXXX---------o-gXXXXXXXXXXXXXXXXXXX--o--------tt----||||--XXXXXXXXXXXXXXXXXXX
------o-tt--XXXXXXXXXXX--o----------XXXXXXXXXXXXXXXXXXXXXXXXXXXXXXXXXXXXXXXXXXXXXXXXXXXXXXXXXXXXXXXXXXXXXXXX-----------tt----|||XXXXXXXXXXXXXXXXXXXXXX
--------tt-oXXXXXXXXXXX-----g-yo----XXXXXXXXXXXXXXXXXXXXXXXXXXXXXXXXXXXXXXXXXXXXXXXXXXXXXXXXXXXXXXXXXXXXXXXX-----G-----tt-%%%|||XXXXXXXXXXXXXXXXXXXXXX
XXXXXXXXXXXXXXXXXXXXXXXXXXXXXXXXXXXXXXXXXXXXXXXXXXXXXXXXXXXXXXXXXXXXXXXXXXXXXXXXXXXXXXXXXXXXXXXXXXXXXXXXXXXXXXXXXXXXXXXXXXXXXXXXXXXXXXXXXXXXXXXXXXXXXX
XXXXXXXXXXXXXXXXXXXXXXXXXXXXXXXXXXXXXXXXXXXXXXXXXXXXXXXXXXXXXXXXXXXXXXXXXXXXXXXXXXXXXXXXXXXXXXXXXXXXXXXXXXXXXXXXXXXXXXXXXXXXXXXXXXXXXXXXXXXXXXXXXXXXXX
