------------------------------------------------------------------------------------------------------------------------------------------------------
------------------------------------------------------------------------------------------------------------------------------------------------------
------------------------------------------------o-----------------------------------------------------------------------------------------------------
-----------------------------------------------------------------o-------o------------------------------------------------------------tto-------------
------------oo-----------------o------------%%%%------tt-----------o----------------------------------------------------------tt---o--tt---o----------
--------------------------------gg-----tt---||||---%%%tt%-----------oo-------oo-----------------------------------------------tt--o---tt--------------
-------------------------------%%%%-%%-ttY--||||---|||tt|--%%%------------------------------------------------------------o--ott-----Gtt---------F----
--------tt--%%%----------------||||-||-ttXXXXXXXXXXXXXtt|G-|||----g--g--------------------%%%%%---------------------tt------XXXXXXXXXXXXXXXXXXXXXX---o
------G-tt--|||----------------||||-||ottXXXXXXXXXXXXXXXXXXXXXXXXXXXXXXXXXXXXXXX--tt------|||||---------------tt----ttoo----XXXXXXXXXXXXXXXXXXXXXX----
XXXXXXX-tto-XXX---o----------%XXXXXXXXXXXXXXXXXXXXXXXXXXXXXXXXXXXXXXXXXXXXXXXXXXG-tt----o-|||||---------------tt----tt------XXXXXXXXXXXXXXXXXXXXXX---G
XXXXXXX-tt--XXX-------Y------|XXXXXXXXXXXXXXXXXXXXXXXXXXXXXXXXXXXXXXXXXXXXXXXXXXXXXXXXXXXX||||tto------o-----XXXXXXXXXXXXXXXXXXXXXXXXXXXXXXXXXXXXX--%%
XXXXXXXXXXXXXXXXXXXXXXXXXX--o|XXXXXXXXXXXXXXXXXXXXXXXXXXXXXXXXXXXXXXXXXXXXXXXXXXXXXXXXXXXX||||tt----tt--tt---XXXXXXXXXXXXXXXXXXXXXXXXXXXXXXXXXXXXXXXXX
XXXXXXXXXXXXXXXXXXXXXXXXXXXXXXXXXXXXXXXXXXXXXXXXXXXXXXXXXXXXXXXXXXXXXXXXXXXXXXXXXXXXXXXXXX||||tt----tt--tt---XXXXXXXXXXXXXXXXXXXXXXXXXXXXXXXXXXXXXXXXX
XXXXXXXXXXXXXXXXXXXXXXXXXXXXXXXXXXXXXXXXXXXXXXXXXXXXXXXXXXXXXXXXXXXXXXXXXXXXXXXXXXXXXXXXXX||||tt--Gytt--tt-o-XXXXXXXXXXXXXXXXXXXXXXXXXXXXXXXXXXXXXXXXX
XXXXXXXXXXXXXXXXXXXXXXXXXXXXXXXXXXXXXXXXXXXXXXXXXXXXXXXXXXXXXXXXXXXXXXXXXXXXXXXXXXXXXXXXXXXXXXXXXXXXXXXXXXXXXXXXXXXXXXXXXXXXXXXXXXXXXXXXXXXXXXXXXXXXXX
XXXXXXXXXXXXXXXXXXXXXXXXXXXXXXXXXXXXXXXXXXXXXXXXXXXXXXXXXXXXXXXXXXXXXXXXXXXXXXXXXXXXXXXXXXXXXXXXXXXXXXXXXXXXXXXXXXXXXXXXXXXXXXXXXXXXXXXXXXXXXXXXXXXXXX
