------------------------------------------------------------------------------------------------------------------------------------------------------
------------------------------------------------------------------------------------------------------------------------------------------------------
------------------------------------------------------------------------------------------------------------------------------------------------------
----------------------------------------------------------------------------------------------------------------------------------------------GG------
-------------------------------------------------------------------------------------------------o---o---o------G----------------------------%%%%%%%--
---------------------------------------------------------------------------------o-------tt--o----------------%%%%%%%%---------%%---tt-------|||||||--
-----------------------------------------------------%%----------------------tt----------tt---tt--o---tto-----||||||||---------||---tt%------|||||||--
-----------------------------------------------------||----------------------tt----------tto--tt------tt-G-o--||||||||-%%%-----||g--tt|ott---|||||||--
-----------------------------------------------------||----o---o-------------tt-----G----tt---tt------tt%%%---||||||||XXXXXXXXXXXXXXXX|-tt---|||||||--
-------------o-%%%%--------o-------------------------||---------ott--o-----XXXXXXXXXXXXXXXXXXXXXXXXXXXXXXXXXXXXXXXXXXXXXXXXXXXXXXXXXXX|-tt---|tt||||--
------------%%%||||---------------------o-tt%%o------||-----o----tt--------XXXXXXXXXXXXXXXXXXXXXXXXXXXXXXXXXXXXXXXXXXXXXXXXXXXXXXXXXXX|-tt--y|tt|F||--
-------XXXX-||||||tt---------------------ott||-------||----yG----tt--------XXXXXXXXXXXXXXXXXXXXXXXXXXXXXXXXXXXXXXXXXXXXXXXXXXXXXXXXXXXXXXXXXXXXXXXXX--
------oXXXX-||||||tt--o-%%%%%%tt----------tt||-------||--%%%%%--gtt--------XXXXXXXXXXXXXXXXXXXXXXXXXXXXXXXXXXXXXXXXXXXXXXXXXXXXXXXXXXXXXXXXXXXXXXXXX--
-------XXXXXXXXXXXXXX--g||||||tt--------G-tt||--G--XXXXXXXXXXXXXXXXXXXXXXXXXXXXXXXXXXXXXXXXXXXXXXXXXXXXXXXXXXXXXXXXXXXXXXXXXXXXXXXXXXXXXXXXXXXXXXXXX--
XXXXXXXXXXXXXXXXXXXXXXXXXXXXXXXXXXXXXXXXXXXXXXXXXXXXXXXXXXXXXXXXXXXXXXXXXXXXXXXXXXXXXXXXXXXXXXXXXXXXXXXXXXXXXXXXXXXXXXXXXXXXXXXXXXXXXXXXXXXXXXXXXXXXXX
XXXXXXXXXXXXXXXXXXXXXXXXXXXXXXXXXXXXXXXXXXXXXXXXXXXXXXXXXXXXXXXXXXXXXXXXXXXXXXXXXXXXXXXXXXXXXXXXXXXXXXXXXXXXXXXXXXXXXXXXXXXXXXXXXXXXXXXXXXXXXXXXXXXXXX
