------------------------------------------o-------------------------o----------------------------------o------------------oo--------------------------
-------------------------------------------------------------------------------------------------------------------------------tt---------------------
------------------------------------------------------------o------------------------------------------------------------------tt---------------------
---------------------------y-y--------------gg-------------ott--------------------------o-------------o------------------------ttygGy-----------------
--------------------------%%%%%---------oY-%%%%%%o-----g----tt%%-----------G---o---o-------------------------------Y-y-------Y-tt%%%%%---o------------
--------------------------|||||---------XXXXXXXXXX---%XXXXXXXXXXXXXXXXXX-%%tt%--------o-----o-tt----o-XXXXXXXXXXXXXXXXXXXXXXXXXXXX||||----------------
----------------------oo--|||||--------%XXXXXXXXXXXXXXXXXXXXXXXXXXXXXXXX-||tt|----------------tt------XXXXXXXXXXXXXXXXXXXXXXXXXXXX||||--tttt---o-----%
--------------------------|||||------G-|XXXXXXXXXXXXXXXXXXXXXXXXXXXXXXXX-||tt|g--o-G-Y--g--o--tto-Y---XXXXXXXXXXXXXXXXXXXXXXXXXXXX||||--tttt-----F---|
-------------tt----o----o-|||||-----XXXXXXXXXXXXXXXXXXXXXXXXXXXXXXXXXXXXXXXXXXXXXXXXXXXXXXXXXXXXXXXXXXXXXXXXXXXXXXXXXXXXXXXXXXXXXXXXXXXXXXXXXXXXXXXXXX
-------------tt-----------|||||-o---XXXXXXXXXXXXXXXXXXXXXXXXXXXXXXXXXXXXXXXXXXXXXXXXXXXXXXXXXXXXXXXXXXXXXXXXXXXXXXXXXXXXXXXXXXXXXXXXXXXXXXXXXXXXXXXXXX
------y----o-tto----------|||||-----XXXXXXXXXXXXXXXXXXXXXXXXXXXXXXXXXXXXXXXXXXXXXXXXXXXXXXXXXXXXXXXXXXXXXXXXXXXXXXXXXXXXXXXXXXXXXXXXXXXXXXXXXXXXXXXXXX
XXXXXXXXXXXXXXXXXXXXXXXXXXXXXXXXXXXXXXXXXXXXXXXXXXXXXXXXXXXXXXXXXXXXXXXXXXXXXXXXXXXXXXXXXXXXXXXXXXXXXXXXXXXXXXXXXXXXXXXXXXXXXXXXXXXXXXXXXXXXXXXXXXXXXX
XXXXXXXXXXXXXXXXXXXXXXXXXXXXXXXXXXXXXXXXXXXXXXXXXXXXXXXXXXXXXXXXXXXXXXXXXXXXXXXXXXXXXXXXXXXXXXXXXXXXXXXXXXXXXXXXXXXXXXXXXXXXXXXXXXXXXXXXXXXXXXXXXXXXXX
XXXXXXXXXXXXXXXXXXXXXXXXXXXXXXXXXXXXXXXXXXXXXXXXXXXXXXXXXXXXXXXXXXXXXXXXXXXXXXXXXXXXXXXXXXXXXXXXXXXXXXXXXXXXXXXXXXXXXXXXXXXXXXXXXXXXXXXXXXXXXXXXXXXXXX
XXXXXXXXXXXXXXXXXXXXXXXXXXXXXXXXXXXXXXXXXXXXXXXXXXXXXXXXXXXXXXXXXXXXXXXXXXXXXXXXXXXXXXXXXXXXXXXXXXXXXXXXXXXXXXXXXXXXXXXXXXXXXXXXXXXXXXXXXXXXXXXXXXXXXX
XXXXXXXXXXXXXXXXXXXXXXXXXXXXXXXXXXXXXXXXXXXXXXXXXXXXXXXXXXXXXXXXXXXXXXXXXXXXXXXXXXXXXXXXXXXXXXXXXXXXXXXXXXXXXXXXXXXXXXXXXXXXXXXXXXXXXXXXXXXXXXXXXXXXXX
