------------------------------------------------------------------------------------------------------------------------------------------------------
------------------------------------------------------------------------------------------------------------------------------------------------------
------------------------------------------------------------------------------------------------------------------------------------------------------
------------------------------------------------------------------------------------------------------------------------------------------------------
------------------------------------------------------------------------------------------------------------------------------------------------------
------------------------------------------------------------------------------------------------------------------------------------------------------
------------------------------------------------------------------------------------------------------------------------------------------------------
------------------------------------------------------------------------------------------------------------------------------------------------------
------------------------------------------------------------------------------------------------------------------------------------------------------
------------UUU----------------------------------------------------TT---------------------------------------------------------------------------------
--------tt---------------------------------------------------------TT--------------TT--------------------------------------U--------------yy----------
--------tt---------------------------------------------------------TT--------------TT---------------------------------------------------@@-@@---------
--------tt---------------------------------------------------------TT--------------TT---------------------------------------------tt----------------F-
-M------tt-----r-------------------------------------------------ggTTkkk--------k--TT-----r------------------------------kk-------tt-----rrr--------#-
XXXXXXXXXXXXXXXXXXXXXXXX----XXXXXXXX---XXXXXX-----XXXXXXXXX----XXXXXXXXXXX-----XXXXXXXXXXXXXX---XXXXXXXX-----XXXXXXXXX---XXXXXXXXXXXXXXXXXXXXXXXXXXXXX
XXXXXXXXXXXXXXXXXXXXXXXX----XXXXXXXX---XXXXXX-----XXXXXXXXX----XXXXXXXXXXX-----XXXXXXXXXXXXXX---XXXXXXXX-----XXXXXXXXX---XXXXXXXXXXXXXXXXXXXXXXXXXXXXX
