------------------------------------------------------------------------------------------------------------------------------------------------------
------------------------------------------------------------------------------------------------------------------------------------------------------
------------------------------------------------------------------------------------------------------------------------------------------------------
------------------------------------------------------------------------------------------------------------------------------------------------------
------------------------------------------------------------------------------------------------------------------------------------------------------
------------------------------------------------------------------------------------------------------------------------------------------------------
------------------------------------------------------------------------------------------------------------------------------------------------------
------------------------------------------------------------------------------------------------------------------------------------------------------
------------------------------------------------------------------------------------------------------------------------------------------------------
----------------------------------------------------------------------------------------------------------------------------------------tt------------
-----tt----U----------------------------------------------------------------------------------------------------------------------------tt------------
-----tt---------------------------------------------------------------------------------------------------------------------------------tt------------
-----tt---------------------------------------------------------------------------------------------------------------------------------tt----------F-
-M---tt--RRR-------------------------------------------------------------------------------------------------------------------------G--tt----------#G
XXXXXXXXXXXXXXXXXXXX----XXXXXXXXX-----XXXXX----XXXXXXXXXXXXX---XXXXXXXXXXXXXXXXX---XXXXXX----XXXXXXXXXXXXXXXXXXXXXXXXXXXXXXXXXXXX---XXXXXXXXXXXXXXXXXX
XXXXXXXXXXXXXXXXXXXX----XXXXXXXXX-----XXXXX----XXXXXXXXXXXXX---XXXXXXXXXXXXXXXXX---XXXXXX----XXXXXXXXXXXXXXXXXXXXXXXXXXXXXXXXXXXX---XXXXXXXXXXXXXXXXXX
