------------------------------------------------------------------------------------------------------------------------------------------------------
------------------------------------------------------------------------------------------------------------------------------------------------------
------------------------------------------------------------------------------------------------------------------------------------------------------
------------------------------------------------------------------------------------------------------------------------------------------------------
------------------------------------------------------------------------------------------------------------------------------------------------------
------------------------------------------------------------------------------------------------------------------------------------------------------
------------------------------------------------------------------------------------------------------------------------------------------------------
------------------------------------------------------------------------------------------------------------------------------------------------------
------------------------------------------------------------------------------------------------------------------------------------------------------
------------------------------------------------------------------------------------------------------------------------------------------------------
------------------------------------------------------------------------------------------------------------------------------------------------------
-----tt-------------tt--------------------------------------------------------------------------------------------------------------------------------
-----tt-------------tt------------------------------------------------------------------------------tt----------------------------------------------F-
-M---ttYYY----------tt----K----------------------------------------------------------------------kk-tt---------y------------------------------------#-
XXXXXXXXXXXXX----XXXXXXXXXXX-----XXXXXXXXXXXXXXXXX-----XXXXXXXXXX---XXXXXXXXXXXXXX---XXXXXXX----XXXXXXXXXXXXXXXXX----XXXXXXXXXX---XXXXXXX-----XXXXXXXX
XXXXXXXXXXXXX----XXXXXXXXXXX-----XXXXXXXXXXXXXXXXX-----XXXXXXXXXX---XXXXXXXXXXXXXX---XXXXXXX----XXXXXXXXXXXXXXXXX----XXXXXXXXXX---XXXXXXX-----XXXXXXXX
