------------------------------------------------------------------------------------------------------------------------------------------------------
------------------------------------------------------------------------------------------------------------------------------------------------------
------------------------------------------------------------------------------------------------------------------------------------------------------
------------------------------------------------------------------------------------------------------------------------------------------------------
------------------------------------------------------------------------------------------------------------------------------------------------------
------------------------------------------------------------------------------------------------------------------------------------------------------
------------------------------------------------------------------------------------------------------------------------------------------------------
------------------------------------------------------------------------------------------------------------------------------------------------------
------------------------------------------------------------------------------------------------------------------------------------------------------
--------tt-----------------------------tt---------------------------------------------------------tt--------------------------------------------------
--------tt------kkk--------------------tt-LLL---------------------TT------------------------------tt--------------------------------------------------
--------tt----@SLLS@-------------------tt-------------------------TT-!-!--------------------------tt--------------------------------@@----------------
--------tt-----------------------------tt-------------------------TT------------------------------tt-------------------------tt---------------------F-
-M------tt------------g------------k---tt---rr--------------------TT------r-------------------y---ttGG-----------------------tt--g------------------#-
XXXXXXXXXXXXXXXXXXXXXXXXXXXXXXXX---XXXXXXXXXXXXXXX---XXXXXXX---XXXXXXXXXXXXXXX----XXXXXXXXX---XXXXXXXXXXXXX---XXXXXXX-----XXXXXXXXXXXXXXXXXXXXX--XXXXX
XXXXXXXXXXXXXXXXXXXXXXXXXXXXXXXX---XXXXXXXXXXXXXXX---XXXXXXX---XXXXXXXXXXXXXXX----XXXXXXXXX---XXXXXXXXXXXXX---XXXXXXX-----XXXXXXXXXXXXXXXXXXXXX--XXXXX
