------------------------------------------------------------------------------------------------------------------------------------------------------
------------------------------------------------------------------------------------------------------------------------------------------------------
------------------------------------------------------------------------------------------------------------------------------------------------------
------------------------------------------------------------------------------------------------------------------------------------------------------
------------------------------------------------------------------------------------------------------------------------------------------------------
------------------------------------------------------------------------------------------------------------------------------------------------------
------------------------------------------------------------------------------------------------------------------------------------------------------
------------------------------------------------------------------------------------------------------------------------------------------------------
------------------------------------------------------------------------------------------------------------------------------------------------------
---tt-------------------------------------------------------------------------------------------------------------------------------------------------
---tt-U---------------------------------------------------------------------------------------------------------------------------------tt------------
---tt------------------------------------------------------------tt-CC---------------LL-------------------------------------------------tt------------
---tt------------------------------------------------------------tt---------------TT----------------------------------------------------tt----------F-
-M-tt------rrr---------------------------------------------------ttgg-------------TT------------yyy---------------------------------r---tt---kk-----#-
XXXXXXXXXXXXXXX----XXXXXXXXX----XXXXXXXXXXXXXXXXXX---XXXXX----XXXXXXXXXXXX-----XXXXXXXXXXXXXXXXXXX---XXXXXXXXXXXXXXXXXXXXXXXXX----XXXXXXXXXXXXXXXXXXXX
XXXXXXXXXXXXXXX----XXXXXXXXX----XXXXXXXXXXXXXXXXXX---XXXXX----XXXXXXXXXXXX-----XXXXXXXXXXXXXXXXXXX---XXXXXXXXXXXXXXXXXXXXXXXXX----XXXXXXXXXXXXXXXXXXXX
