------------------------------------------------------------------------------------------------------------------------------------------------------
------------------------------------------------------------------------------------------------------------------------------------------------------
------------------------------------------------------------------------------------------------------------------------------------------------------
------------------------------------------------------------------------------------------------------------------------------------------------------
------------------------------------------------------------------------------------------------------------------------------------------------------
------------------------------------------------------------------------------------------------------------------------------------------------------
------------------------------------------------------------------------------------------------------------------------------------------------------
------------------------------------------------------------------------------------------------------------------------------------------------------
------------------------------------------------------------------------------------------------------------------------------------------------------
---tt-------------------------------------------------------tt-------------------------------tt-------------------------------------------------------
---tt---------------tt--------------------------------------tt-------------------------------tt----UU--------------tt---------------------------------
---tt---------------tt--------------------------------------tt-------------------------------tt--------------------tt---------------------------------
---tt---------------tt--------------------------------------tt-------------------------------tt--------------------tt-------------------------------F-
-M-ttk------------g-tt--yyy------------------------------kk-tt-yyy---------------------------tt------rrr-----------ttr------------------------------#-
XXXXXXXXXXX----XXXXXXXXXXXXX---XXXXXX----XXXXXXXXXX-----XXXXXXXXXXX-----XXXXX-----XXXXX---XXXXXXXXXXXXXXXXXX----XXXXXXXXXXX-----XXXXXXXX----XXXXXXXXXX
XXXXXXXXXXX----XXXXXXXXXXXXX---XXXXXX----XXXXXXXXXX-----XXXXXXXXXXX-----XXXXX-----XXXXX---XXXXXXXXXXXXXXXXXX----XXXXXXXXXXX-----XXXXXXXX----XXXXXXXXXX
