------------------------------------------------------------------------------------------------------------------------------------------------------
------------------------------------------------------------------------------------------------------------------------------------------------------
------------------------------------------------------------------------------------------------------------------------------------------------------
------------------------------------------------------------------------------------------------------------------------------------------------------
------------------------------------------------------------------------------------------------------------------------------------------------------
------------------------------------------------------------------------------------------------------------------------------------------------------
------------------------------------------------------------------------------------------------------------------------------------------------------
------------------------------------------------------------------------------------------------------------------------------------------------------
------------------------------------------------------------------------------------------------------------------------------------------------------
------------------------------------------------------------------------------------------------------------------------------------------------------
--------------------------------------------------------tt---!!------------------tt-------------------------------------------------------------------
--------------------------------------------------------tt-----------------------tt-------------------------------------------------------------------
----TT--------------------------------------------------tt-----------------------tt-----------------------------------------------------------------F-
-M--TT-------gg-----------------------------------------tt---YY---------------kkktt----gg-----------------------------------------------------------#-
XXXXXXXXXXXXXXX----XXXXXXXX----XXXXXXXX-----XXXXX----XXXXXXXXXXXXXXXXX-----XXXXXXXXXXXXXXXXXXXXXXXXXXXXXXXXXXXXXX-----XXXXXXXXXXXXXXXXXXXXXXXXXXXXXXXX
XXXXXXXXXXXXXXX----XXXXXXXX----XXXXXXXX-----XXXXX----XXXXXXXXXXXXXXXXX-----XXXXXXXXXXXXXXXXXXXXXXXXXXXXXXXXXXXXXX-----XXXXXXXXXXXXXXXXXXXXXXXXXXXXXXXX
