------------------------------------------------------------------------------------------------------------------------------------------------------
------------------------------------------------------------------------------------------------------------------------------------------------------
------------------------------------------------------------------------------------------------------------------------------------------------------
------------------------------------------------------------------------------------------------------------------------------------------------------
------------------------------------------------------------------------------------------------------------------------------------------------------
------------------------------------------------------------------------------------------------------------------------------------------------------
----------@------------------------S------------------------------------------------------------------------------------------------------------------
------------------------------------------------------------------------------------------------------------------------------------------------------
------------------------------------------------------------------------------------------------------------------------------------------------------
----------------------------------------------------------------------------U!!U----------------------------------------------------------------------
----------SLS------------------tt----------------------------------------TT---------------------------------------------------------------------------
------tt-----------------------tt--CC------------------------------------TT---------------------------------------------------------------------------
------tt-----------------------tt----------------------------------------TT---------------------------------------------------tt--------------------F-
-M----tt-------gg-----------r--tt------y-------------------------------yyTT--------k------------------------------------------tt---r----------------#-
XXXXXXXXXXXXXXXXXXXXXX----XXXXXXXXXXXXXXXXX---XXXXXXX-----XXXXX----XXXXXXXXXXXXXXXXXXXXX----XXXXXX-----XXXXXXXXXXXXXXXX----XXXXXXXXXXXXXXXXXXXX--XXXXX
XXXXXXXXXXXXXXXXXXXXXX----XXXXXXXXXXXXXXXXX---XXXXXXX-----XXXXX----XXXXXXXXXXXXXXXXXXXXX----XXXXXX-----XXXXXXXXXXXXXXXX----XXXXXXXXXXXXXXXXXXXX--XXXXX
