------------------------------------------------------------------------------------------------------------------------------------------------------
------------------------------------------------------------------------------------------------------------------------------------------------------
------------------------------------------------------------------------------------------------------------------------------------------------------
------------------------------------------------------------------------------------------------------------------------------------------------------
------------------------------------------------------------------------------------------------------------------------------------------------------
------------------------------------------------------------------------------------------------------------------------------------------------------
------------------------------------------------------------------------------------------------------------------------------------------------------
------------------------------------------------------------------------------------------------------------------------------------------------------
------------------------------------------------------------------------------------------------------------------------------------------------------
---------------------------------------------------------------------tt-------------------------------------------------------------------------------
---------------------------------------------------------------------tt--------------------------------tt---------------tt--------U-U-----------------
---------------------------------------------------------------------tt--------------------------------tt---------------tt----------------------------
---------------------------------------------------------------------tt--------------------------------tt---------------tt--------------------------F-
-M-------------------------------------------------------------------tt--yy-------------------------rr-ttkkk---------yy-tt-----------------------rr-#-
XXXXXXXX----XXXXXXXXXXXXXXXXXXXXXXXXXXXXXXXXXXXXXX---XXXXXXXX----XXXXXXXXXXXXXXXXXXXXXXXXXXXX-----XXXXXXXXXXXXX-----XXXXXXXXXXXXXXXXXXXXXXXXXXXXXXXXXX
XXXXXXXX----XXXXXXXXXXXXXXXXXXXXXXXXXXXXXXXXXXXXXX---XXXXXXXX----XXXXXXXXXXXXXXXXXXXXXXXXXXXX-----XXXXXXXXXXXXX-----XXXXXXXXXXXXXXXXXXXXXXXXXXXXXXXXXX
