------------------------------------------------------------------------------------------------------------------------------------------------------
------------------------------------------------------------------------------------------------------------------------------------------------------
------------------------------------------------------------------------------------------------------------------------------------------------------
------------------------------------------------------------------------------------------------------------------------------------------------------
------------------------------------------------------------------------------------------------------------------------------------------------------
------------------------------------------------------------------------------------------------------------------------------------------------------
----------L-L-----------------------------------------------------------------------------------------------------------------------------------------
------------------------------------------------------------------------------------------------------------------------------------------------------
------------------------------------------------------------------------------------------------------------------------------------------------------
-----tt-----------------------------------------------------------------------------------------------------------------------------------------------
-----tt---yyy-----------------------------------------------------------------------------------------------------------------------------------------
-----tt--@SCCS@------------------------------------------------------------------------------------------------------------tt--C-C--------------------
-----tt-------------------------------tt-----------------------------------------------------------------------------------tt-----------------------F-
-M---tt---------y-------------------r-tt-----------------------yy----------------------------------------------------yy----tt---R-------------------#-
XXXXXXXXXXXXXXXXXXXXXXXXXXXXXX----XXXXXXXXXXXXXXXXXXXXXXXXXXXXXXXXXXXXX---XXXXXXXXXXXXXXXXXXXXXXX-----XXXXXXXXXX---XXXXXXXXXXXXXXXXXXXXXXXXX---XXXXXXX
XXXXXXXXXXXXXXXXXXXXXXXXXXXXXX----XXXXXXXXXXXXXXXXXXXXXXXXXXXXXXXXXXXXX---XXXXXXXXXXXXXXXXXXXXXXX-----XXXXXXXXXX---XXXXXXXXXXXXXXXXXXXXXXXXX---XXXXXXX
