------------------------------------------------------------------------------------------------------------------------------------------------------
------------------------------------------------------------------------------------------------------------------------------------------------------
------------------------------------------------------------------------------------------------------------------------------------------------------
------------------------------------------------------------------------------------------------------------------------------------------------------
------------------------------------------------------------------------------------------------------------------------------------------------------
------------------------------------------------------------------------------------------------------------------------------------------------------
------------------------------------------------------------------------------------------------------------------------------------------------------
------------------------------------------------------------------------------------------------------------------------------------------------------
------------------------------------------------------------------------------------------------------------------------------------------------------
-----------------------------------------------------------------------------------------------------tt-----------------------tt----------------------
-----------------------------------------------------------------------------------------------------tt----S-S----------------tt----------------------
-----------------------------------------------------------------------------------------------------tt-----------------------tt----------------------
-------------------------------------------------------------------------------------tt--------------tt-----------------------tt--------------------F-
-M-----------------------------------------------------------------------------------ttgg------------tt--ggg--------------yy--tt-rr-----------------#-
XXXXXXXXXXXXX-----XXXXX---XXXXXXX-----XXXXXXXXX---XXXXX-----XXXXXXX----XXXXXXXX---XXXXXXXXXXX-----XXXXXXXXXXXXXXXXXXX-----XXXXXXXXXXXXXXXX---XXXXXXXXX
XXXXXXXXXXXXX-----XXXXX---XXXXXXX-----XXXXXXXXX---XXXXX-----XXXXXXX----XXXXXXXX---XXXXXXXXXXX-----XXXXXXXXXXXXXXXXXXX-----XXXXXXXXXXXXXXXX---XXXXXXXXX
