------------------------------------------------------------------------------------------------------------------------------------------------------
------------------------------------------------------------------------------------------------------------------------------------------------------
------------------------------------------------------------------------------------------------------------------------------------------------------
------------------------------------------------------------------------------------------------------------------------------------------------------
------------------------------------------------------------------------------------------------------------------------------------------------------
------------------------------------------------------------------------------------------------------------------------------------------------------
------------------------------------------------------------------------------------------------------------------------------------------------------
------------------------------------------------------------------------------------------------------------------------------------------------------
------------------------------------------------------------------------------------------------------------------------------------------------------
---------------------------SS-------------------------------------------------------------------------------------------------------------------------
-----------------------------------------------------------------tt-----------------------------------------------------------------------------------
------------------------------------------------tt---------------tt-CC-----------------------------tt-------------------------------------------------
--------------------tt--------------------------tt---------------tt--------------------------------tt-------------------------------tt--------------F-
-M------------------tt--yy-------------------kkkttyy-------------tt-gg------------------------ggg--tt--k-------------------------rr-tt---y----------#-
XXXXXXXXXXXX----XXXXXXXXXXXXXXXXXXXXXXX---XXXXXXXXXXXXXXXXX---XXXXXXXXXXXXX----XXXXXXXXX----XXXXXXXXXXXXXXXXXXXXXXXXXXXXXXX-----XXXXXXXXXXXX-----XXXXX
XXXXXXXXXXXX----XXXXXXXXXXXXXXXXXXXXXXX---XXXXXXXXXXXXXXXXX---XXXXXXXXXXXXX----XXXXXXXXX----XXXXXXXXXXXXXXXXXXXXXXXXXXXXXXX-----XXXXXXXXXXXX-----XXXXX
