------------------------------------------------------------------------------------------------------------------------------------------------------
------------------------------------------------------------------------------------------------------------------------------------------------------
------------------------------------------------------------------------------------------------------------------------------------------------------
------------------------------------------------------------------------------------------------------------------------------------------------------
------------------------------------------------------------------------------------------------------------------------------------------------------
------------------------------------------------------------------------------------------------------------------------------------------------------
------------------------------------------------------------------------------------------------------------------------------------------------------
------------------------------------------------------------------------------------------------------------------------------------------------------
------------------------------------------------------------------------------------------------------------------------------------------------------
-------------------------------------------------------------------tt---------------------------------------------k-----------------------------------
--------tt--!!-----------------------------------------------------tt-----------------------------------@CCCU@SS@UCCC@--------------------------------
--@@----tt---------------------------------------------------------tt---U-U---------------------------------------------------------------------------
--------tt---------------------------------------------------------tt------------------------------tt-----------------------------------------------F-
-M------tt-----------kk---------------------------------------yyy--ttyy----------------------------tt----------------------------------rr-----------#-
XXXXXXXXXXXXXXXXXXXXXXXX---XXXXXXXXXXXXXXXXXXXXX-----XXXXXX---XXXXXXXXXXXXXXXXXXX----XXXXXXX----XXXXXXXXXXXXXXXXXXXXXXXXXXXXXXXXXXXXXXXXXXXXXXXXXXXXXX
XXXXXXXXXXXXXXXXXXXXXXXX---XXXXXXXXXXXXXXXXXXXXX-----XXXXXX---XXXXXXXXXXXXXXXXXXX----XXXXXXX----XXXXXXXXXXXXXXXXXXXXXXXXXXXXXXXXXXXXXXXXXXXXXXXXXXXXXX
