------------------------------------------------------------------------------------------------------------------------------------------------------
------------------------------------------------------------------------------------------------------------------------------------------------------
------------------------------------------------------------------------------------------------------------------------------------------------------
------------------------------------------------------------------------------------------------------------------------------------------------------
------------------------------------------------------------------------------------------------------------------------------------------------------
------------------------------------------------------------------------------------------------------------------------------------------------------
------------------------------------------------------------------------------------------------------------------------------------------------------
------------------------------------------------------------------------------------------------------------------------------------------------------
------------------------------------------------------------------------------------------------------------------------------------------------------
-----------------------------------tt-------------------------------------------tt------------------------------------------tt------------------------
-----------------------------------tt--!!------------------------tt-------------tt------------------------------------------tt------------------------
-----------------------------------tt----------------------------tt-------------tt------------------------------------------tt------------------------
---tt------------------------------tt----------------------------tt-------------tt----------------TT------------------------tt--------------TT------F-
-M-ttyy-------------------------YY-tt-rrr------------------------tt--yy---------tt--rr------------TT-------y--------------kktt---gg-------Y-TT----y-#-
XXXXXXXXXXXX----XXXXXXXXXXXX---XXXXXXXXXXXXXX----XXXXXXXXX----XXXXXXXXXXXX---XXXXXXXXXXXXXX----XXXXXXXXXXXXXXXXXXXXX---XXXXXXXXXXXX-----XXXXXXXXXXXXXX
XXXXXXXXXXXX----XXXXXXXXXXXX---XXXXXXXXXXXXXX----XXXXXXXXX----XXXXXXXXXXXX---XXXXXXXXXXXXXX----XXXXXXXXXXXXXXXXXXXXX---XXXXXXXXXXXX-----XXXXXXXXXXXXXX
