------------------------------------------------------------------------------------------------------------------------------------------------------
------------------------------------------------------------------------------------------------------------------------------------------------------
------------------------------------------------------------------------------------------------------------------------------------------------------
------------------------------------------------------------------------------------------------------------------------------------------------------
------------------------------------------------------------------------------------------------------------------------------------------------------
------------------------------------------------------------------------------------------------------------------------------------------------------
------------------------------------------------------------------------------------------------------------------------------------------------------
------------------------------------------------------------------------------------------------------------------------------------------------------
------------------------------------------------------------------------------------------------------------------------------------------------------
------------------------------------------tt-----------------------------------------tt---------------------------------------------------------------
------------------------------------------tt-----------------------------------------tt---------------------------------------------------------------
---------------------------C-C------------tt-----------------------------------------tt---------------------------------------------tt----------------
------------------------TT----------------tt-----------------------------------------tt---------------------------------------------tt--------------F-
-M----------------------TT-r--------------tt--gg-------------------------------------tt---kkk---------------------------------------tt-----yy-------#-
XXXXXXXXXX---XXXX---XXXXXXXXXXXXXXXX---XXXXXXXXXXXXXX----XXXXXXXXXX----XXXXXXXX---XXXXXXXXXXX-----XXXXXXX---XXXXXXX----XXXXXX----XXXXXXXXXXXXXXX-XXXXX
XXXXXXXXXX---XXXX---XXXXXXXXXXXXXXXX---XXXXXXXXXXXXXX----XXXXXXXXXX----XXXXXXXX---XXXXXXXXXXX-----XXXXXXX---XXXXXXX----XXXXXX----XXXXXXXXXXXXXXX-XXXXX
