------------------------------------------------------------------------------------------------------------------------------------------------------
------------------------------------------------------------------------------------------------------------------------------------------------------
------------------------------------------------------------------------------------------------------------------------------------------------------
------------------------------------------------------------------------------------------------------------------------------------------------------
------------------------------------------------------------------------------------------------------------------------------------------------------
------------------------------------------------------------------------------------------------------------------------------------------------------
------------------------------------------------------------------------------------------------------------------------------------------------------
------------------------------------------------------------------------------------------------------------------------------------------------------
------------------------------------------------------------------------------------------------------------------------------------------------------
------------------------------------------------------------------------------------------------------------------------------------------------------
------------------------------------------------------------------------------UU-----tt--------------------------!!-----------------------------------
-------------------------------------------------------tt----------------------------tt-SUS-----------------------------------------------------------
------------tt-------------TT--------------------------tt----------------------------tt-----------------------tt--------------TT--------------------F-
-M----------tt----yyy---y--TT-----KK-----------------kktt---yyy----------------ggg---tt----ggg-------------rr-tt----gg------yyTT----kkk-------------#-
XXXXX---XXXXXXXXXXX---XXXXXXXXXXXXX---XXXXXXXXX---XXXXXXXXXXXXX---XXXXXX-----XXXXXXXXXXXXXXXXXXXXXXXX-----XXXXXXXXXXXXX---XXXXXXXXXXXXXXX---XXXXXXXXXX
XXXXX---XXXXXXXXXXX---XXXXXXXXXXXXX---XXXXXXXXX---XXXXXXXXXXXXX---XXXXXX-----XXXXXXXXXXXXXXXXXXXXXXXX-----XXXXXXXXXXXXX---XXXXXXXXXXXXXXX---XXXXXXXXXX
