------------------------------------------------------------------------------------------------------------------------------------------------------
------------------------------------------------------------------------------------------------------------------------------------------------------
------------------------------------------------------------------------------------------------------------------------------------------------------
------------------------------------------------------------------------------------------------------------------------------------------------------
------------------------------------------------------------------------------------------------------------------------------------------------------
------------------------------------------------------------------------------------------------------------------------------------------------------
------------------------------------------------------------------------------------------------------------------------------------------------------
------------------------------------------------------------------------------------------------------------------------------------------------------
------------------------------------------------------------------------------------------------------------------------------------------------------
----------------------------------------------------------------------tt--------------------------------------------tt--------------------------------
-------------------------------------tt--C-C--------------------------tt--------------------------------------------tt--------------------------------
-------------------!-----------------tt-------------------------------tt---------------tt---------------------------tt--------------------------------
----------------TT-------------------tt-------------------------------tt---------------tt---------------------------tt------------------------------F-
-M--------------TT------kk-------r---tt-------yy-------------------g--tt---k---------rrtt-RRR-------------------yy--tt-GG---------------------------#-
XXXXXXXX---XXXXXXXXXXXXXXXXX---XXXXXXXXXXXXXXXXXXX---XXXXXXXX----XXXXXXXXXXXXX-----XXXXXXXXXXXXX-----XXXXXX----XXXXXXXXXXXXXX---XXXXXXXXXXXX----XXXXXX
XXXXXXXX---XXXXXXXXXXXXXXXXX---XXXXXXXXXXXXXXXXXXX---XXXXXXXX----XXXXXXXXXXXXX-----XXXXXXXXXXXXX-----XXXXXX----XXXXXXXXXXXXXX---XXXXXXXXXXXX----XXXXXX
