------------------------------------------------------------------------------------------------------------------------------------------------------
------------------------------------------------------------------------------------------------------------------------------------------------------
------------------------------------------------------------------------------------------------------------------------------------------------------
------------------------------------------------------------------------------------------------------------------------------------------------------
------------------------------------------------------------------------------------------------------------------------------------------------------
------------------------------------------------------------------------------------------------------------------------------------------------------
------------------------------------------------------------------------------------------------------------------------------------------------------
------------------------------------------------------------------------------------------------------------------------------------------------------
------------------------------------------------------------------------------------------------------------------------------------------------------
-------------------------------------------------------------------TT---------------------------------------------------------------------------------
-----------------tt------------------------------------------------TT-CC------------------------------------------------------------------------------
-----------------tt------------------------------------------------TT---------------------------------------------------------------------------------
-----------------tt------------------------------------------------TT-------------------------------------------------------------------------------F-
-M---------------tt-----rrr----------------------------------------TTrrr----------------------------------------------------------------------------#-
XXXXXXXX----XXXXXXXXXXXXXXXXXXXXX---XXXXXXX-----XXXXXXXXXXXX----XXXXXXXXXXXX-----XXXXXXXXXXXXX-----XXXXXX-----XXXXXXXXX----XXXXX---XXXXXX----XXXXXXXXX
XXXXXXXX----XXXXXXXXXXXXXXXXXXXXX---XXXXXXX-----XXXXXXXXXXXX----XXXXXXXXXXXX-----XXXXXXXXXXXXX-----XXXXXX-----XXXXXXXXX----XXXXX---XXXXXX----XXXXXXXXX
