------------------------------------------------------------------------------------------------------------------------------------------------------
------------------------------------------------------------------------------------------------------------------------------------------------------
------------------------------------------------------------------------------------------------------------------------------------------------------
------------------------------------------------------------------------------------------------------------------------------------------------------
------------------------------------------------------------------------------------------------------------------------------------------------------
------------------------------------------------------------------------------------------------------------------------------------------------------
------------------------------------------------------------------------------------------------------------------------------------------------------
------------------------------------------------------------------------------------------------------------------------------------------------------
------------------------------------------------------------------------------------------------------------------------------------------------------
-----tt-------------------------------------------------------------------------------------------------------------@---------------------------------
-----tt--@@---------------------------------------------------------tt-----------------------------------------------------tt-------------------------
-----tt--------------------------------------------------@-@--------tt-----------------------------------------------------tt-------------------------
-----tt-------------------------------------------------------------tt-----------------------------------------------------tt-----------------------F-
-M---tt--kkk------------------------------------------------------rrtt------------------YY-------------------------------y-tt----------r------------#-
XXXXXXXXXXXXXX-----XXXXXXXX---XXXXX---XXXXXXX----XXXX---XXXXXXXXXXXXXXXXXXXXXXXXXXXXXXXXXXXXXXXX-----XXXXXXXX-----XXXXXXXXXXXXXXXXXXXXXXXXXXXXXX-XXXXX
XXXXXXXXXXXXXX-----XXXXXXXX---XXXXX---XXXXXXX----XXXX---XXXXXXXXXXXXXXXXXXXXXXXXXXXXXXXXXXXXXXXX-----XXXXXXXX-----XXXXXXXXXXXXXXXXXXXXXXXXXXXXXX-XXXXX
