------------------------------------------------------------------------------------------------------------------------------------------------------
------------------------------------------------------------------------------------------------------------------------------------------------------
------------------------------------------------------------------------------------------------------------------------------------------------------
------------------------------------------------------------------------------------------------------------------------------------------------------
------------------------------------------------------------------------------------------------------------------------------------------------------
------------------------------------------------------------------------------------------------------------------------------------------------------
------------------------------------------------------------------------------------------------------------------------------------------------------
------------------------------------------------------------------------------------------------------------------------------------------------------
------------------------------------------------------------------------------------------------------------------------------------------------------
---------------------------------------------------------------------------TT------------------------------------------!------------------------------
---------------------------------------------------------------------------TT-------------------------------------------------------------------------
---------------------------------------------------------------------------TT-------------------------------------------------------------------------
---------------------------------------------------------------------------TT--------------------------------------TT-------------------------------F-
-M-------------------------------------------------------------------------TT---y--------------------------------rrTT--------r----------------------#-
XXXXXXXXXX-----XXXXXXXXXXXXXXXXXXXXXXXXXXXX----XXXXXXXXXXXXXXXXXXX-----XXXXXXXXXXXXXXXXXXX-----XXXXXXXXXXXX----XXXXXXXXXXXXXXX---XXXXXXXXXX----XXXXXXX
XXXXXXXXXX-----XXXXXXXXXXXXXXXXXXXXXXXXXXXX----XXXXXXXXXXXXXXXXXXX-----XXXXXXXXXXXXXXXXXXX-----XXXXXXXXXXXX----XXXXXXXXXXXXXXX---XXXXXXXXXX----XXXXXXX
