------------------------------------------------------------------------------------------------------------------------------------------------------
------------------------------------------------------------------------------------------------------------------------------------------------------
------------------------------------------------------------------------------------------------------------------------------------------------------
------------------------------------------------------------------------------------------------------------------------------------------------------
------------------------------------------------------------------------------------------------------------------------------------------------------
------------------------------------------------------------------------------------------------------------------------------------------------------
------------------------------------------------------------------------------------------------------------------------------------------------------
------------------------------------------------------------------------------------------------------------------------------------------------------
------------------------------------------------------------------------------------------------------------------------------------------------------
-----------------UU-------------tt--------------------------------------------------------------------------------------------------------------------
--------------tt----------------tt-@@-----------------------------------------------------------------------------------------------------------------
--------------tt----------------tt------------------------------------------------tt------------------------------------------------------------------
--------------tt----------------tt------------------------------------------------tt----------------------------------------------------------------F-
-M------------tt--k-------------tt-kkk------------------------------------------ggtt------------------k---------------------------------------------#-
XXXXXX-----XXXXXXXXXXXXX-----XXXXXXXXXXXX-----XXXXX---XXXXXXXXXX----XXXXXXX---XXXXXXXXXXXXXXXXXXXXXXXXXXXXXXXXXXXXX---XXXXXXXXXXXXXXXXXXXXXXXXXXXXXXXX
XXXXXX-----XXXXXXXXXXXXX-----XXXXXXXXXXXX-----XXXXX---XXXXXXXXXX----XXXXXXX---XXXXXXXXXXXXXXXXXXXXXXXXXXXXXXXXXXXXX---XXXXXXXXXXXXXXXXXXXXXXXXXXXXXXXX
