------------------------------------------------------------------------------------------------------------------------------------------------------
------------------------------------------------------------------------------------------------------------------------------------------------------
------------------------------------------------------------------------------------------------------------------------------------------------------
------------------------------------------------------------------------------------------------------------------------------------------------------
------------------------------------------------------------------------------------------------------------------------------------------------------
------------------------------------------------------------------------------------------------------------------------------------------------------
------------------------------------------------------------------------------------------------------------------------------------------------------
------------------------------------------------------------------------------------------------------------------------------------------------------
------------------------------------------------------------------------------------------------------------------------------------------------------
------------------------------------------------------------!U!---------------------------------------------------------------------------------------
----------------tt--------------------tt--UU-------------TT-------------------------------------------------------------------------------------------
----------------tt--------------------tt-----------------TT-------------------------------------------------------------------------------------------
----------------tt--------------------tt-----------------TT-------------------tt--------------------------------------------------------------------F-
-M--------------tt----gg------------yytt--------yyy----kkTT---------r-------ggtt---------------------------------yy---------------------------------#-
XXXXXXXXX---XXXXXXXXXXXXXXXXXX---XXXXXXXXXXXXXXXX----XXXXXXXXXXXXXXXXX---XXXXXXXXXXXXXXXXXXXXXXXXXXXXXXXXXXXXXXXXXXXXXXXXXXXXXXXXXXX----XXXXXXXX-XXXXX
XXXXXXXXX---XXXXXXXXXXXXXXXXXX---XXXXXXXXXXXXXXXX----XXXXXXXXXXXXXXXXX---XXXXXXXXXXXXXXXXXXXXXXXXXXXXXXXXXXXXXXXXXXXXXXXXXXXXXXXXXXX----XXXXXXXX-XXXXX
