------------------------------------------------------------------------------------------------------------------------------------------------------
------------------------------------------------------------------------------------------------------------------------------------------------------
------------------------------------------------------------------------------------------------------------------------------------------------------
------------------------------------------------------------------------------------------------------------------------------------------------------
------------------------------------------------------------------------------------------------------------------------------------------------------
------------------------------------------------------------------------------------------------------------------------------------------------------
------------------------------------------------------------------------------------------------------------------------------------------------------
------------------------------------------------------------------------------------------------------------------------------------------------------
------------------rr----------------------------------------------------------------------------------------------------------------------------------
--------tt-----SLCLS------------------------------------------------------tt--------------------------------------------------------------------------
--------tt----------------------------------------------------------------tt--------------------------------------------------------------------------
--------tt----------------------------------------------------------------tt--------------------------------------------------------------------------
--------tt----------------------------------------------------------------tt-------------------------------------------------------tt---------------F-
-M------tt-------------g-----------------------------------------------gg-ttyyy----------------------------------------------------tt---------yy----#-
XXXXXXXXXXXXXXXXXXXXXXXXXXXXXXX----XXXXXXXX-----XXXXXX----XXXXXXXX----XXXXXXXXXXX-----XXXXX---XXXXXXXXXXXXXX----XXXXXXXXXXXXX---XXXXXXXXXXXXXXX--XXXXX
XXXXXXXXXXXXXXXXXXXXXXXXXXXXXXX----XXXXXXXX-----XXXXXX----XXXXXXXX----XXXXXXXXXXX-----XXXXX---XXXXXXXXXXXXXX----XXXXXXXXXXXXX---XXXXXXXXXXXXXXX--XXXXX
