------------------------------------------------------------------------------------------------------------------------------------------------------
------------------------------------------------------------------------------------------------------------------------------------------------------
------------------------------------------------------------------------------------------------------------------------------------------------------
------------------------------------------------------------------------------------------------------------------------------------------------------
------------------------------------------------------------------------------------------------------------------------------------------------------
------------------------------------------------------------------------------------------------------------------------------------------------------
------------------------------------------------------------------------------------------------------------------------------------------------------
------------------------------------------------------------------------------------------------------------------------------------------------------
------------------------------------------------------------------------------------------------------------------------------------------------------
------------------------------------------------------------------------------------------------------------------------------------------------------
------------------------------------------------------------------------------------------------S-S---------------------------------------------------
---------------------------------------------------------------------------------------------tt-------------------------------------------------------
---------------------------------------------------------------------------------------------tt-----------------------------------------------------F-
-M-------------------------------------------------------------------------------------------ttkk---------------------------------------------------#-
XXXXXX-----XXXXXXX---XXXXXXXXXXXXXXXXXXXXXXXXX---XXXXXXXXXXXXXXXXXXXXXXXXXXXXXXXX-----XXXXXXXXXXXXXXXXXXXXX-----XXXXXXXXXX-----XXXXXXX-----XXXXXXXXXXX
XXXXXX-----XXXXXXX---XXXXXXXXXXXXXXXXXXXXXXXXX---XXXXXXXXXXXXXXXXXXXXXXXXXXXXXXXX-----XXXXXXXXXXXXXXXXXXXXX-----XXXXXXXXXX-----XXXXXXX-----XXXXXXXXXXX
