------------------------------------------------------------------------------------------------------------------------------------------------------
------------------------------------------------------------------------------------------------------------------------------------------------------
------------------------------------------------------------------------------------------------------------------------------------------------------
------------------------------------------------------------------------------------------------------------------------------------------------------
------------------------------------------------------------------------------------------------------------------------------------------------------
------------------------------------------------------------------------------------------------------------------------------------------------------
------------------------------------------------------------------------------------------------------------------------------------------------------
------------------------------------------------------------------------------------------------------------------------------------------------------
------------------------------------------------------------------------------------------------------------------------------------------------------
---------------------------------------------------------------------------------S-S---------------------------------------------------------TT-------
---------------------------------------------------------------------------------------------------------------------------------------------TT-------
------------------------------------------------------------------------------tt-------------------------------------------------------------TT-------
------------------------------------------------------------------------------tt-------------------------------------------------------------TT-----F-
-M----------------------------------------------------------------------------tt-----GGG-----------------------------------------------------TT-----#-
XXXXXXX---XXXXXXX----XXXXX----XXXXXXX-----XXXXXXXXXX-----XXXXXXXXXX-----XXXXXXXXXXXXXXXXXXXXXXXXX-----XXXXXXX---XXXXXXXXX---XXXXXXXXX-----XXXXXXXXXXXX
XXXXXXX---XXXXXXX----XXXXX----XXXXXXX-----XXXXXXXXXX-----XXXXXXXXXX-----XXXXXXXXXXXXXXXXXXXXXXXXX-----XXXXXXX---XXXXXXXXX---XXXXXXXXX-----XXXXXXXXXXXX
