------------------------------------------------------------------------------------------------------------------------------------------------------
------------------------------------------------------------------------------------------------------------------------------------------------------
------------------------------------------------------------------------------------------------------------------------------------------------------
------------------------------------------------------------------------------------------------------------------------------------------------------
------------------------------------------------------------------------------------------------------------------------------------------------------
------------------------------------------------------------------------------------------------------------------------------------------------------
------------------------------------------------------------------------------------------------------------------------------------------------------
------------------------------------------------------------------------------------------------------------------------------------------------------
------------------------------------------------------------------------------------------------------------------------------------------------------
------------------------------------------------------------------------------------------------------------------------------------------------------
------------------------------------------------------------------------------------------------------------------------------------------------------
------------------------------------------------------------------------------------------------------------------------------------------------------
--------------------------------------------tt---------------------------------------------tt-------------------------------------------------------F-
-M------------------------------------------tt----y------------------------------------k---tt---yyy-------------------------------------------------#-
XXXXXXX-----XXXXXXXX----XXXXXXXXX-----XXXXXXXXXXXXXXXXXXX-----XXXXXXXXXX---XXXXXXXX----XXXXXXXXXXX-----XXXXXXX----XXXXXX-----XXXXXXXXX-----XXXXXXXXXXX
XXXXXXX-----XXXXXXXX----XXXXXXXXX-----XXXXXXXXXXXXXXXXXXX-----XXXXXXXXXX---XXXXXXXX----XXXXXXXXXXX-----XXXXXXX----XXXXXX-----XXXXXXXXX-----XXXXXXXXXXX
