------------------------------------------------------------------------------------------------------------------------------------------------------
------------------------------------------------------------------------------------------------------------------------------------------------------
------------------------------------------------------------------------------------------------------------------------------------------------------
------------------------------------------------------------------------------------------------------------------------------------------------------
------------------------------------------------------------------------------------------------------------------------------------------------------
------------------------------------------------------------------------------------------------------------------------------------------------------
------------------------------------------------------------------------------------------------------------------------------------------------------
------------------------------------------------------------------------------------------------------------------------------------------------------
------------------------------------------------------------------------------------------------------------------------------------------------------
-----------------------------------L------------------------------------------------UU------------------------------------------------------tt--------
---------------------------------------------------------------------------------TT---------------------------------------------------------tt--------
------------TT-------------------------------------------------------------------TT---------------------------------------------------------tt--------
------------TT----------------tt-------------------------------------------------TT---------------------------------------------------------tt------F-
-M----------TT-----kkk--kk----tt-------k---------------------------------------rrTT---YYY----------------------------------------------yy---tt----rr#-
XXXXX---XXXXXXXXXXXX----XXXXXXXXXXXXXXXXXX----XXXXXXXXXXXXXX-----XXXXXXX-----XXXXXXXXXXXXX----XXXXXXXXXX----XXXXXXXXXXXXXXXXXXXXXXX----XXXXXXXXXXXXXXX
XXXXX---XXXXXXXXXXXX----XXXXXXXXXXXXXXXXXX----XXXXXXXXXXXXXX-----XXXXXXX-----XXXXXXXXXXXXX----XXXXXXXXXX----XXXXXXXXXXXXXXXXXXXXXXX----XXXXXXXXXXXXXXX
