------------------------------------------------------------------------------------------------------------------------------------------------------
------------------------------------------------------------------------------------------------------------------------------------------------------
------------------------------------------------------------------------------------------------------------------------------------------------------
------------------------------------------------------------------------------------------------------------------------------------------------------
------------------------------------------------------------------------------------------------------------------------------------------------------
------------------------------------------------------------------------------------------------------------------------------------------------------
------------------------------------------------------------------------------------------------------------------------------------------------------
------------------------------------------------------------------------------------------------------------------------------------------------------
------------------------------------------------------------------------------------------------------------------------------------------------------
----------------------------------------------------------------------------------------------------------------TT---------------------tt-------------
----------------------------------------------------------------------------------------------------------------TT---------------------tt-------------
----------------------------------------------------------------------------------------------------------------TT---------------------tt-------------
--------------TT------------------------------------------------------------------------------------------------TT---------------------tt-----------F-
-M------------TT---g------------------------------------------------------------------------------------------kkTT---g-----------------tt----rr-----#-
XXXXXX---XXXXXXXXXXXX---XXXXXXXX---XXXXXXXXXXXXXXXXXXXXXXXXXXXXXXXXXXXXXXXXXXXXXXXXXXXXXXXXXXXXXXXXXXXX-----XXXXXXXXXXXXX---XXXXX---XXXXXXXXXXXXXXXXXX
XXXXXX---XXXXXXXXXXXX---XXXXXXXX---XXXXXXXXXXXXXXXXXXXXXXXXXXXXXXXXXXXXXXXXXXXXXXXXXXXXXXXXXXXXXXXXXXXX-----XXXXXXXXXXXXX---XXXXX---XXXXXXXXXXXXXXXXXX
