------------------------------------------------------------------------------------------------------------------------------------------------------
------------------------------------------------------------------------------------------------------------------------------------------------------
------------------------------------------------------------------------------------------------------------------------------------------------------
------------------------------------------------------------------------------------------------------------------------------------------------------
------------------------------------------------------------------------------------------------------------------------------------------------------
------------------------------------------------------------------------------------------------------------------------------------------------------
------------------------------------------------------------------------------------------------------------------------------------------------------
------------------------------------------------------------------------------------------------------------------------------------------------------
------------------------------------------------------------------------------------------------------------------------------------------------------
------------------------------------------------------------------------------S@@S------------------------------@@------------------------------------
------------------------------------------------------------------------------------------------------------------------------------------------------
---------------------------------------------------------------------------tt-------------------------------------------------------------------------
-----tt--------------------------------------------------------------------tt-------------------------------tt--------------------------------------F-
-M---tt---r-----------------------------------------------------------rr---tt------yy-----------------------tt-------k------------------------------#-
XXXXXXXXXXXXXXX-----XXXXXXXXXXX---XXXXXXXXXX-----XXXXXX----XXXXXXX----XXXXXXXXXXXXXXXXXXX----XXXXXXX-----XXXXXXXXXXXXX---XXXXXXXXXXXXXX-----XXXXXXXXXX
XXXXXXXXXXXXXXX-----XXXXXXXXXXX---XXXXXXXXXX-----XXXXXX----XXXXXXX----XXXXXXXXXXXXXXXXXXX----XXXXXXX-----XXXXXXXXXXXXX---XXXXXXXXXXXXXX-----XXXXXXXXXX
