------------------------------------------------------------------------------------------------------------------------------------------------------
------------------------------------------------------------------------------------------------------------------------------------------------------
------------------------------------------------------------------------------------------------------------------------------------------------------
------------------------------------------------------------------------------------------------------------------------------------------------------
------------------------------------------------------------------------------------------------------------------------------------------------------
------------------------------------------------------------------------------------------------------------------------------------------------------
------------------------------------------------------------------------------------------------------------------------------------------------------
------------------------------------------------------------------------------------------------------------------------------------------------------
------------------------------------------------------------------------------------------------------------------------------------------------------
------------------------------------tt----------------------------------------------------------------------------------------------------------------
------------------------------------tt----------------------------------------------------------------------------------------------------------------
------------------------------------tt------SS--------------------------------------------------------------------------------------------------------
------------------------------------tt--------------------------------------------------------------------------------------------tt----------------F-
-M----------------------------------tt---yy---------------------------------------------------------------------------------------ttk---------------#-
XXXXXXXXXXXXX----XXXXXXXXXX-----XXXXXXXXXXXXXXXXXXXXXXXXXXX-----XXXXXXXXXXXXXXXXX----XXXXX---XXXXXXXXXXXXXXX----XXXXXXXXXX-----XXXXXXXXXXXXXXXXXXXXXXX
XXXXXXXXXXXXX----XXXXXXXXXX-----XXXXXXXXXXXXXXXXXXXXXXXXXXX-----XXXXXXXXXXXXXXXXX----XXXXX---XXXXXXXXXXXXXXX----XXXXXXXXXX-----XXXXXXXXXXXXXXXXXXXXXXX
