------------------------------------------------------------------------------------------------------------------------------------------------------
------------------------------------------------------------------------------------------------------------------------------------------------------
------------------------------------------------------------------------------------------------------------------------------------------------------
------------------------------------------------------------------------------------------------------------------------------------------------------
------------------------------------------------------------------------------------------------------------------------------------------------------
------------------------------------------------------------------------------------------------------------------------------------------------------
------------------------------------------------------------------------------------------------------------------------------------------------------
------------------------------------------------------------------------------------------------------------------------------------------------------
------------------------------------------------------------------------------------------------------------------------------------------------------
------------------------------------------------------------------------------------------------------------------------------------------------------
------------------------------------------------------------------------------------------------------------------------------------------------------
-------------------------------------------------------------L-L--------------------------------------------------------------------------------------
----------------------------------------------------------tt----------------------------------------------------------------------------------------F-
-M--------------------------------------------------------tt--------r-------------------------------------------------------------------------------#-
XXXXXXX-----XXXXXXX-----XXXXXXXXXX---XXXXXXXXXXXXX---XXXXXXXXXXXXXXXX----XXXXXXXX-----XXXXXXXXXXXXXXXXXX---XXXXXXX-----XXXXXXXXX----XXXXXXX---XXXXXXXX
XXXXXXX-----XXXXXXX-----XXXXXXXXXX---XXXXXXXXXXXXX---XXXXXXXXXXXXXXXX----XXXXXXXX-----XXXXXXXXXXXXXXXXXX---XXXXXXX-----XXXXXXXXX----XXXXXXX---XXXXXXXX
