------------------------------------------------------------------------------------------------------------------------------------------------------
------------------------------------------------------------------------------------------------------------------------------------------------------
------------------------------------------------------------------------------------------------------------------------------------------------------
------------------------------------------------------------------------------------------------------------------------------------------------------
------------------------------------------------------------------------------------------------------------------------------------------------------
------------------------------------------------------------------------------------------------------------------------------------------------------
------------------------------------------------------------------------------------------------------------------------------------------------------
------------------------------------------------------------------------------------------------------------------------------------------------------
------------------------------------------------------------------------------------------------------------------------------------------------------
---------------------------------------------------------------------------------------tt-------------------------------------------------------------
---------------------------------------------------------------------------------------tt-------------------------------------------------------------
---------------------------------------------------------------------------------------tt-------------------------------------------------------------
----------------TT---------------------------------------------------------------------tt-------------------------------TT--------------------------F-
-M--------------TT--kkk----------------------------------------------------------rr----tt--------------------k------r---TT----G---------------------#-
XXXXXXXX----XXXXXXXXXXX---XXXXXXXX---XXXXXXXXXXXXXXXXXXX----XXXXXXXXXXXXXX----XXXXXXXXXXXXXXXXXXXXXXXXXXXXXXXXXXX---XXXXXXXXXXX---XXXXXXXXXX---XXXXXXX
XXXXXXXX----XXXXXXXXXXX---XXXXXXXX---XXXXXXXXXXXXXXXXXXX----XXXXXXXXXXXXXX----XXXXXXXXXXXXXXXXXXXXXXXXXXXXXXXXXXX---XXXXXXXXXXX---XXXXXXXXXX---XXXXXXX
