------------------------------------------------------------------------------------------------------------------------------------------------------
------------------------------------------------------------------------------------------------------------------------------------------------------
------------------------------------------------------------------------------------------------------------------------------------------------------
------------------------------------------------------------------------------------------------------------------------------------------------------
------------------------------------------------------------------------------------------------------------------------------------------------------
------------------------------------------------------------------------------------------------------------------------------------------------------
------------------------------------------------------------------------------------------------------------------------------------------------------
------------------------------------------------------------------------------------------------------------------------------------------------------
------------------------------------------------------------------------------------------------------------------------------------------------------
--------------------------------------!UU!--------------------------------------------------------------------L@@L------------------------------------
----------------------------------tt----------------------------------------------------------SS------------------------------------------------------
----------------------------------tt-----------------------------------------------------------------------tt-----------------------------------------
----------------------------------tt------------------------------------------------------tt---------------tt---------------------------------------F-
-M--------------------------------tt--RRR-------------------------------------------------tt------kk-------tt---------------g-----------------------#-
XXXXXXXXXXXXXXXX---XXXXXXX----XXXXXXXXXXXXXXXXXX----XXXXXXXX-----XXXXXXXXXXX---XXXXX---XXXXXXXXXXXXX----XXXXXXXXXXXXXXXXXXXXXXXXX---XXXXXXXX----XXXXXX
XXXXXXXXXXXXXXXX---XXXXXXX----XXXXXXXXXXXXXXXXXX----XXXXXXXX-----XXXXXXXXXXX---XXXXX---XXXXXXXXXXXXX----XXXXXXXXXXXXXXXXXXXXXXXXX---XXXXXXXX----XXXXXX
