------------------------------------------------------------------------------------------------------------------------------------------------------
------------------------------------------------------------------------------------------------------------------------------------------------------
------------------------------------------------------------------------------------------------------------------------------------------------------
------------------------------------------------------------------------------------------------------------------------------------------------------
------------------------------------------------------------------------------------------------------------------------------------------------------
------------------------------------------------------------------------------------------------------------------------------------------------------
------------------------------------------------------------------------------------------------------------------------------------------------------
------------------------------------------------------------------------------------------------------------------------------------------------------
------------------------------------------------------------------------------------------------------------------------------------------------------
------------------------@@----------------------kk-------------------------------------tt-------------------------tt--CC------------------------------
-----tt--------------------------------------@L@@L@------------------------------------tt---SS--------------------tt----------------------------------
-----tt-------------------------------tt-----------------------------------------------tt-------------------------tt----------------------------------
-----tt--------------tt---------------tt-----------------------------------------------tt-------------------------tt--------------------------------F-
-M---tt---yyy----gg--tt---gg--------g-tt-------------ggg---------------------------r---tt---------kk------------rrtt-----------r--------------------#-
XXXXXXXXXXXX-----XXXXXXXXXXXXX----XXXXXXXXXXXXXXXXXXXXXXXX---XXXXXXXXXX---XXXXXX---XXXXXXXXXXXXXXXXXXXXXXXX---XXXXXXXXXXXXXXXXXXX----XXXXXXXXXX--XXXXX
XXXXXXXXXXXX-----XXXXXXXXXXXXX----XXXXXXXXXXXXXXXXXXXXXXXX---XXXXXXXXXX---XXXXXX---XXXXXXXXXXXXXXXXXXXXXXXX---XXXXXXXXXXXXXXXXXXX----XXXXXXXXXX--XXXXX
