------------------------------------------------------------------------------------------------------------------------------------------------------
------------------------------------------------------------------------------------------------------------------------------------------------------
------------------------------------------------------------------------------------------------------------------------------------------------------
------------------------------------------------------------------------------------------------------------------------------------------------------
------------------------------------------------------------------------------------------------------------------------------------------------------
------------------------------------------------------------------------------------------------------------------------------------------------------
------------------------------------------------------------------------------------------------------------------------------------------------------
------------------------------------------------------------------------------------------------------------------------------------------------------
------------------------------------------------------------------------------------------------------------------------------------------------------
-----------------------------------------------------------------------------------------------------TT-----------------------------------------------
-----------------------------------------------------------------------------------------------------TT-----------------------------------------------
-----------------------------------------------------------------------------------------------------TT-----------------------------TT----------------
-------------------------------------------tt-------------------------tt-----------------------------TT-----------------------------TT--------------F-
-M-----------------------------------------tt--gg---------------------tt--yy-------------------------TT-----rrr------------------rr-TT-kk-----------#-
XXXXXXXX----XXXXXXXXXX----XXXXXXX---XXXXXXXXXXXXXXXXXXXXXXXXXX-----XXXXXXXXXXXXXXX---XXXXXXXXXX---XXXXXXXXXXXX-----XXXXXXXXXX---XXXXXXXXXXXX----XXXXXX
XXXXXXXX----XXXXXXXXXX----XXXXXXX---XXXXXXXXXXXXXXXXXXXXXXXXXX-----XXXXXXXXXXXXXXX---XXXXXXXXXX---XXXXXXXXXXXX-----XXXXXXXXXX---XXXXXXXXXXXX----XXXXXX
