------------------------------------------------------------------------------------------------------------------------------------------------------
------------------------------------------------------------------------------------------------------------------------------------------------------
------------------------------------------------------------------------------------------------------------------------------------------------------
------------------------------------------------------------------------------------------------------------------------------------------------------
------------------------------------------------------------------------------------------------------------------------------------------------------
------------------------------------------------------------------------------------------------------------------------------------------------------
------------------------------------------------------------------------------------------------------------------------------------------------------
------------------------------------------------------------------------------------------------------------------------------------------------------
------------------------------------------------------------------------------------------------------------------------------------------------------
--------------------------------------------------------------------------------------------------------TT-----------------------------tt-------------
--------------------------------------------------------------------------------------------------------TT-----------------------------tt-------------
-----------tt-------------------------------------------------------------------------------------------TT-LL--------------------------tt-------------
-----------tt-------------------------------------------------------------------------------------------TT-----------------------------tt-----------F-
-M---------tt---------------yy------------------------------------------------------------------------yyTTRR------------------------rrrtt-gg--------#-
XXXXXXXXXXXXXXXXXXXXXXXXXXXXXXXXXXXXX-----XXXXXX-----XXXXXXXX-----XXXXXX---XXXXXXXXX----XXXXXXX-----XXXXXXXXXXXXX-----XXXXXXX-----XXXXXXXXXXXXXX-XXXXX
XXXXXXXXXXXXXXXXXXXXXXXXXXXXXXXXXXXXX-----XXXXXX-----XXXXXXXX-----XXXXXX---XXXXXXXXX----XXXXXXX-----XXXXXXXXXXXXX-----XXXXXXX-----XXXXXXXXXXXXXX-XXXXX
