------------------------------------------------------------------------------------------------------------------------------------------------------
------------------------------------------------------------------------------------------------------------------------------------------------------
------------------------------------------------------------------------------------------------------------------------------------------------------
------------------------------------------------------------------------------------------------------------------------------------------------------
------------------------------------------------------------------------------------------------------------------------------------------------------
------------------------------------------------------------------------------------------------------------------------------------------------------
------------------------------------------------------------------------------------------------------------------------------------------------------
------------------------------------------------------------------------------------------------------------------------------------------------------
------------------------------------------------------------------------------------------------------------------------------------------------------
------tt--------------------------------------------------------------------------------------------------------------------------tt------------------
------tt------------------------tt-@-@-------------------------------tt-----------------------------------------------------------tt------------------
------tt-----CC-----------------tt-----------------------------------tt-----------------------------------------------------------tt------------------
------tt------------------------tt-----------------------------------tt-----------------------------------------------------------tt----------------F-
-M----tt--------------yy--------tt----------yy-----------------------tt--------gg-------------------------------------------------tt---rrr----------#-
XXXXXXXXXXXXXXXXXXXXXXXXXX---XXXXXXXXXXXXXXXXX---XXXXXXXXXXXX-----XXXXXXXXXXXXXXXX-----XXXXXXXXX----XXXXXXXXXXXX----XXXXXX-----XXXXXXXXXXX-----XXXXXXX
XXXXXXXXXXXXXXXXXXXXXXXXXX---XXXXXXXXXXXXXXXXX---XXXXXXXXXXXX-----XXXXXXXXXXXXXXXX-----XXXXXXXXX----XXXXXXXXXXXX----XXXXXX-----XXXXXXXXXXX-----XXXXXXX
