------------------------------------------------------------------------------------------------------------------------------------------------------
------------------------------------------------------------------------------------------------------------------------------------------------------
------------------------------------------------------------------------------------------------------------------------------------------------------
------------------------------------------------------------------------------------------------------------------------------------------------------
------------------------------------------------------------------------------------------------------------------------------------------------------
------------------------------------------------------------------------------------------------------------------------------------------------------
------------------------------------------------------------------------------------------------------------------------------------------------------
------------------------------------------------------------------------------------------------------------------------------------------------------
------------------------------------------------------------------------------------------------------------------------------------------------------
------------------------------------------------------------------------------------------------------------------------------------------------------
-----tt-----------------------------------------------------------------------------------------------------------------------------------------------
-----tt-----------------tt---U--------------------------------tt---------------------------------CC---------------------------------------------------
-----tt-----------------tt------------------------------------tt----------------------------tt------------------------------------------------------F-
-M---tt----RRR-------kkktt----y-------------------------------tt--y----------------------g--tt----------------------yy------------------------------#-
XXXXXXXXXXXXXX-----XXXXXXXXXXXXXXXXX----XXXXX-----XXXXXX---XXXXXXXXXXXX----XXXXXX----XXXXXXXXXXXXXXXXXXXXXXXXXXXXXXXX---XXXXXXXXXX----XXXXXXXX---XXXXX
XXXXXXXXXXXXXX-----XXXXXXXXXXXXXXXXX----XXXXX-----XXXXXX---XXXXXXXXXXXX----XXXXXX----XXXXXXXXXXXXXXXXXXXXXXXXXXXXXXXX---XXXXXXXXXX----XXXXXXXX---XXXXX
