------------------------------------------------------------------------------------------------------------------------------------------------------
------------------------------------------------------------------------------------------------------------------------------------------------------
------------------------------------------------------------------------------------------------------------------------------------------------------
------------------------------------------------------------------------------------------------------------------------------------------------------
------------------------------------------------------------------------------------------------------------------------------------------------------
------------------------------------------------------------------------------------------------------------------------------------------------------
------------------------------------------------------------------------------------------------------------------------------------------------------
------------------------------------------------------------------------------------------------------------------------------------------------------
------------------------------------------------------------------------------------------------------------------------------------------------------
------------------------------------------tt-S--------------------------------------------------------------------------------------------------------
------------------------------------------tt----------------------------------------------------------------------------------------------------------
------------------------------------------tt----------------------------------------------------------------------------------------------------------
------------------------------------------tt----------------------------------------------------TT--------------------------------------------------F-
-M----------------------------------------tt-------kkk---------------------------------------y--TT--kkk---------------------------------------------#-
XXXXXXXXXX---XXXXXXXXXX-----XXXXXXXX---XXXXXXXXXXXXX----XXXXXX-----XXXXXX-----XXXXXXXXXX---XXXXXXXXXXXXX-----XXXXXXXXX----XXXXXX----XXXXXXXXXXXXXXXXXX
XXXXXXXXXX---XXXXXXXXXX-----XXXXXXXX---XXXXXXXXXXXXX----XXXXXX-----XXXXXX-----XXXXXXXXXX---XXXXXXXXXXXXX-----XXXXXXXXX----XXXXXX----XXXXXXXXXXXXXXXXXX
