------------------------------------------------------------------------------------------------------------------------------------------------------
------------------------------------------------------------------------------------------------------------------------------------------------------
------------------------------------------------------------------------------------------------------------------------------------------------------
------------------------------------------------------------------------------------------------------------------------------------------------------
------------------------------------------------------------------------------------------------------------------------------------------------------
------------------------------------------------------------------------------------------------------------------------------------------------------
------------------------------------------------------------------------------------------------------------------------------------------------------
------------------------------------------------------------------------------------------------------------------------------------------------------
------------------------------------------------------------------------------------------------------------------------------------------------------
----------------------------!!------------------------------------------------------------------------------------------------------------------------
------------------------------------------------------------------------------------------------------------------------------------------------------
------------------------------------------------------------------------------------------------------------------------------------------------------
------------------------tt---------------------------------------------------------------tt---------------------------------------------------------F-
-M----------------------tty--------------------------------------------------------------tt-----yy--------------------------------------------------#-
XXXXX---XXXXXX---XXXXXXXXXXXXXXXXXXXXXXX----XXXXXX---XXXXXXXXX---XXXXXXX---XXXXXXXX---XXXXXXXXXXXX-----XXXXX---XXXXXXX-----XXXXXX----XXXXXXXX---XXXXXX
XXXXX---XXXXXX---XXXXXXXXXXXXXXXXXXXXXXX----XXXXXX---XXXXXXXXX---XXXXXXX---XXXXXXXX---XXXXXXXXXXXX-----XXXXX---XXXXXXX-----XXXXXX----XXXXXXXX---XXXXXX
