------------------------------------------------------------------------------------------------------------------------------------------------------
------------------------------------------------------------------------------------------------------------------------------------------------------
------------------------------------------------------------------------------------------------------------------------------------------------------
------------------------------------------------------------------------------------------------------------------------------------------------------
------------------------------------------------------------------------------------------------------------------------------------------------------
------------------------------------------------------------------------------------------------------------------------------------------------------
------------------------------------------------------------------------------------------------------------------------------------------------------
------------------------------------------------------------------------------------------------------------------------------------------------------
------------------------------------------------------------------------------------------------------------------------------------------------------
----------------------------------------------------------------------------------tt------------------------------------------------------------------
-----tt----------------tt---------------------------------------------------------tt----L------------------------------------------------tt-----------
-----tt----------------tt---------------------------------------------------------tt--------------------------------------tt-------------tt-----------
-----tt----------------tt---------------------------------------------------------tt--------------------------------------tt-------------tt---------F-
-M---tt---KKK--------GGtt-k-----------------------------------------------------kktt----ggg---------------------------yy--tt----rrr------tt-y-------#-
XXXXXXXXXXXX-----XXXXXXXXXXXXXXXXXXXXX----XXXXXXXXXXX---XXXXXXXXXXXXXXXXX----XXXXXXXXXXXXXXXXXXXXXXXXX---XXXXXXXXXX---XXXXXXXXXXXXX---XXXXXXXXXXXXXXXX
XXXXXXXXXXXX-----XXXXXXXXXXXXXXXXXXXXX----XXXXXXXXXXX---XXXXXXXXXXXXXXXXX----XXXXXXXXXXXXXXXXXXXXXXXXX---XXXXXXXXXX---XXXXXXXXXXXXX---XXXXXXXXXXXXXXXX
