------------------------------------------------------------------------------------------------------------------------------------------------------
------------------------------------------------------------------------------------------------------------------------------------------------------
------------------------------------------------------------------------------------------------------------------------------------------------------
------------------------------------------------------------------------------------------------------------------------------------------------------
------------------------------------------------------------------------------------------------------------------------------------------------------
------------------------------------------------------------------------------------------------------------------------------------------------------
------------------------------------------------------------------------------------------------------------------------------------------------------
------------------------------------------------------------------------------------------------------------------------------------------------------
------------------------------------------------------------------------------------------------------------------------------------------------------
----tt----------------------------------------------------------------tt------------------------------------------tt----------------------------------
----tt---U-U----------------------------------------------------------tt------------------------------------------tt--S-------------------------------
----tt----------------------------------------------------------------tt------------------------------------------tt-----------------tt---------------
----tt----------------------------------------------------------------tt------------------------------------------tt-----------------tt-------------F-
-M--ttyy-----------------------------------------------------------gg-tt--------GG----------------------------r---ttyy-------------k-tt------k------#-
XXXXXXXXXXXXXXXXXXXX-----XXXXXXX---XXXXX-----XXXXXXXXXXXXXXXX-----XXXXXXXXXXXXXXXX---XXXXXXX-----XXXXXXXXXX---XXXXXXXXXXXXXX-----XXXXXXXXXXXXXXXXXXXXX
XXXXXXXXXXXXXXXXXXXX-----XXXXXXX---XXXXX-----XXXXXXXXXXXXXXXX-----XXXXXXXXXXXXXXXX---XXXXXXX-----XXXXXXXXXX---XXXXXXXXXXXXXX-----XXXXXXXXXXXXXXXXXXXXX
