------------------------------------------------------------------------------------------------------------------------------------------------------
------------------------------------------------------------------------------------------------------------------------------------------------------
------------------------------------------------------------------------------------------------------------------------------------------------------
------------------------------------------------------------------------------------------------------------------------------------------------------
------------------------------------------------------------------------------------------------------------------------------------------------------
------------------------------------------------------------------------------------------------------------------------------------------------------
------------------------------------------------------------------------------------------------------------------------------------------------------
------------------------------------------------------------------------------------------------------------------------------------------------------
------------------------------------------------------------------------------------------------------------------------------------------------------
--------------------@@--------------tt--------------------------------------------------------------------------------------tt---------------tt-------
------------------------------------tt--UU----------------------------------------------------------------------------------tt---------------tt-------
------------------------------------tt--------------------------------------------------------------------------------------tt---------------tt-------
----------------tt------------------tt--------------------------------------------------------------------------------------tt---------------tt-----F-
-M--------------tt----y----------r--ttGGG-----------------------------------------------------------------------------------ttR-----------kk-tt-r---#-
XXXXXXXXX---XXXXXXXXXXXXXXXX----XXXXXXXXXXXXXX----XXXXXXXXXXXXXXXXXXXXXXXXXX---XXXXXXXXXXXXXXXXXXXXXXXXXX-----XXXXXXX----XXXXXXXXXXX----XXXXXXXXXXXXXX
XXXXXXXXX---XXXXXXXXXXXXXXXX----XXXXXXXXXXXXXX----XXXXXXXXXXXXXXXXXXXXXXXXXX---XXXXXXXXXXXXXXXXXXXXXXXXXX-----XXXXXXX----XXXXXXXXXXX----XXXXXXXXXXXXXX
