------------------------------------------------------------------------------------------------------------------------------------------------------
------------------------------------------------------------------------------------------------------------------------------------------------------
------------------------------------------------------------------------------------------------------------------------------------------------------
------------------------------------------------------------------------------------------------------------------------------------------------------
------------------------------------------------------------------------------------------------------------------------------------------------------
------------------------------------------------------------------------------------------------------------------------------------------------------
------------------------------------------------------------------------------------------------------------------------------------------------------
------------------------------------------------------------------------------------------------------------------------------------------------------
------------------------------------------------------------------------------------------------------------------------------------------------------
---TT--SS---------------------------------------------------------------------------------------------------------------------------------------------
---TT-------------------------------C@@C--------------------------------------------------------------------------------------------------------------
---TT------------------------tt-----------------------------------------------------------------------------------------------------------------------
---TT------------------------tt---------------------------------------------------------------------------------------------------------------------F-
-M-TT--g-------------------rrtt---------g-----------------------------------------------------------------------------------------------------------#-
XXXXXXXXXXXX----XXXXXX---XXXXXXXXXXXXXXXXXXXXX----XXXXXXXXXXXXXXXXXXXX----XXXXXXXXXXXXXXXXXXXX-----XXXXX---XXXXXXXXX---XXXXXXXXXXXXXXXXXXXX---XXXXXXXX
XXXXXXXXXXXX----XXXXXX---XXXXXXXXXXXXXXXXXXXXX----XXXXXXXXXXXXXXXXXXXX----XXXXXXXXXXXXXXXXXXXX-----XXXXX---XXXXXXXXX---XXXXXXXXXXXXXXXXXXXX---XXXXXXXX
