------------------------------------------------------------------------------------------------------------------------------------------------------
------------------------------------------------------------------------------------------------------------------------------------------------------
------------------------------------------------------------------------------------------------------------------------------------------------------
------------------------------------------------------------------------------------------------------------------------------------------------------
------------------------------------------------------------------------------------------------------------------------------------------------------
------------------------------------------------------------------------------------------------------------------------------------------------------
------------------------------------------------------------------------------------------------------------------------------------------------------
------------------------------------------------------------------------------------------------------------------------------------------------------
------------------------------------------------------------------------------------------------------------------------------------------------------
------------------------------------------------------------------------------------------------------------------------------------------------------
------------------------------------------------------------------------------------------------------------------------------------------------------
------------------------------------------------------------------------------------------------------------------------------------------------------
------------------------------------------------------TT----------------------------------------------------------------------tt--------------------F-
-M----------------------------------------------------TT-----yyy--------------------------------------------------------------tt-----gg-------------#-
XXXXXXXXXXXXXXXXXXXXXXXXXXXXXXXXX----XXXXXXX-----XXXXXXXXXXXXXX-----XXXXXXXX-----XXXXXXXXXXXXXXXXXXXX----XXXXXXXXXXXXX-----XXXXXXXXXXXXX---XXXXXXXXXXX
XXXXXXXXXXXXXXXXXXXXXXXXXXXXXXXXX----XXXXXXX-----XXXXXXXXXXXXXX-----XXXXXXXX-----XXXXXXXXXXXXXXXXXXXX----XXXXXXXXXXXXX-----XXXXXXXXXXXXX---XXXXXXXXXXX
