------------------------------------------------------------------------------------------------------------------------------------------------------
------------------------------------------------------------------------------------------------------------------------------------------------------
------------------------------------------------------------------------------------------------------------------------------------------------------
------------------------------------------------------------------------------------------------------------------------------------------------------
------------------------------------------------------------------------------------------------------------------------------------------------------
------------------------------------------------------------------------------------------------------------------------------------------------------
------------------------------------------------------------------------------------------------------------------------------------------------------
------------------------------------------------------------------------------------------------------------------------------------------------------
------------------------------------------------------------------------------------------------------------------------------------------------------
------------------------------y---------------------------------------------------------------------tt------------------------------------------------
----------------------------!UL-LU!---------------------@@--------------------tt--------------------tt------------------------------------------------
-----------------------------------------------------tt-----------------------tt--!!----------------tt------------------------------------------------
-------------------tt--------------------------------tt-----------------------tt--------------------tt----------------------------------------------F-
-M-----------------tt--g-----------------------------tt--r--------------------tt------yyy--------kkktt----kk----------------------------------------#-
XXXXXXX-----XXXXXXXXXXXXXXXXXXXXXXXXXXXXXXXXXXX---XXXXXXXXXXXX----XXXXX----XXXXXXXXXXXXX----XXXXXXXXXXXXXXXXXXXXXXXXXXXXXXXXXXXXXX---XXXX---XXXXXXXXXX
XXXXXXX-----XXXXXXXXXXXXXXXXXXXXXXXXXXXXXXXXXXX---XXXXXXXXXXXX----XXXXX----XXXXXXXXXXXXX----XXXXXXXXXXXXXXXXXXXXXXXXXXXXXXXXXXXXXX---XXXX---XXXXXXXXXX
