------------------------------------------------------------------------------------------------------------------------------------------------------
------------------------------------------------------------------------------------------------------------------------------------------------------
------------------------------------------------------------------------------------------------------------------------------------------------------
------------------------------------------------------------------------------------------------------------------------------------------------------
------------------------------------------------------------------------------------------------------------------------------------------------------
------------------------------------------------------------------------------------------------------------------------------------------------------
------------------------------------------------------------------------------------------------------------------------------------------------------
------------------------------------------------------------------------------------------------------------------------------------------------------
------------------------------------------------------------------------------------------------------------------------------------------------------
---------------------------------------------------------------------------------------------------tt------------------------------------TT-----------
------------------------------------------------------RR-------------------------------------------tt----!-!-----------------------------TT-----------
------------------------------------------------TT--C!CCC!C----------------------------------------tt------------------------------------TT-----------
------------------------------------------------TT-------------------------------------------------tt------------------------------------TT---------F-
-M----------------------------------------------TT--------------rrr------------------------Y-------tt--------k-----------------------r---TTrr-------#-
XXXXXX---XXXXXXXXXX-----XXXXXXXX----XXXXXXXXXXXXXXXXXXXXXXXXXXXXXXXXXXXXXXXXXXXXXXXXX---XXXXXXXXXXXXXXXXXXXXXXXXXXXXXXXXXXXXXXX-----XXXXXXXXXXXXXXXXXX
XXXXXX---XXXXXXXXXX-----XXXXXXXX----XXXXXXXXXXXXXXXXXXXXXXXXXXXXXXXXXXXXXXXXXXXXXXXXX---XXXXXXXXXXXXXXXXXXXXXXXXXXXXXXXXXXXXXXX-----XXXXXXXXXXXXXXXXXX
