------------------------------------------------------------------------------------------------------------------------------------------------------
------------------------------------------------------------------------------------------------------------------------------------------------------
------------------------------------------------------------------------------------------------------------------------------------------------------
------------------------------------------------------------------------------------------------------------------------------------------------------
------------------------------------------------------------------------------------------------------------------------------------------------------
------------------------------------------------------------------------------------------------------------------------------------------------------
------------------------------------------------------------------------------------------------------------------------------------------------------
------------------------------------------------------------------------------------------------------------------------------------------------------
------------------------------------------------------------------------------------------------------------------------------------------------------
-------------------------------------------------------------------tt---------------------------------------------------------------------------------
---------------------------------------------------tt--------------tt---------------------------------------------------------------------------------
-U-------------------------------------------------tt--------------tt---------------------------------------------------------------------------------
--------tt-----------------------------------------tt--------------tt-------------------------------------------------------------------------------F-
-M------tt-----------------------------y---------yytt--gg--------kktt----kkk------------------------------------------------------------------------#-
XXXXXXXXXXXXXXXXXXXXXXXXXXXXXXXXXXXXXXXXX-----XXXXXXXXXXXX----XXXXXXXXXXXXX---XXXXXXXXXX---XXXXXXXXXXXXXXXX-----XXXXX-----XXXXX----XXXXXXXXXXXXX-XXXXX
XXXXXXXXXXXXXXXXXXXXXXXXXXXXXXXXXXXXXXXXX-----XXXXXXXXXXXX----XXXXXXXXXXXXX---XXXXXXXXXX---XXXXXXXXXXXXXXXX-----XXXXX-----XXXXX----XXXXXXXXXXXXX-XXXXX
