------------------------------------------------------------------------------------------------------------------------------------------------------
------------------------------------------------------------------------------------------------------------------------------------------------------
------------------------------------------------------------------------------------------------------------------------------------------------------
------------------------------------------------------------------------------------------------------------------------------------------------------
------------------------------------------------------------------------------------------------------------------------------------------------------
------------------------------------------------------------------------------------------------------------------------------------------------------
-----------------------------------------------------CC-----------------------------------------------------------------------------------------------
------------------------------------------------------------------------------------------------------------------------------------------------------
------------------------------------------------------------------------------------------------------------------------------------------------------
---------------------TT-----------------------------@UU@-----------------------------------------------TT---------------------------------------------
---------------------TT--------------------------------------------------------------------------------TT---------------------------------------------
----TT---------------TT-----------------------tt------------------------TT-----------------------------TT--SS-----------------------------------------
----TT---------------TT-----------------------tt------------------------TT-----------------------------TT-------------------------------------------F-
-M--TT----r-------rr-TT----G------------------tt--------------RR---y----TTrrr------------------------g-TT----yy-------------------------------------#-
XXXXXXXXXXXXXX---XXXXXXXXXXXX---XXXXXXX----XXXXXXXXXXXXXXXXXXXXX---XXXXXXXXXXXX-----XXXXXXXXX-----XXXXXXXXXXXXXX-----XXXXXXXXXXXXXXXXXXXXXXXX----XXXXX
XXXXXXXXXXXXXX---XXXXXXXXXXXX---XXXXXXX----XXXXXXXXXXXXXXXXXXXXX---XXXXXXXXXXXX-----XXXXXXXXX-----XXXXXXXXXXXXXX-----XXXXXXXXXXXXXXXXXXXXXXXX----XXXXX
