------------------------------------------------------------------------------------------------------------------------------------------------------
------------------------------------------------------------------------------------------------------------------------------------------------------
------------------------------------------------------------------------------------------------------------------------------------------------------
------------------------------------------------------------------------------------------------------------------------------------------------------
------------------------------------------------------------------------------------------------------------------------------------------------------
------------------------------------------------------------------------------------------------------------------------------------------------------
------------------------------------------------------------------------------------------------------------------------------------------------------
------------------------------------------------------------------------------------------------------------------------------------------------------
------------------------------------------------------------------------------------------------------------------------------------------------------
------------------------------------------------------------------------------------------------------------------------------------------------------
------------------------------------------------------------------------------------------------------------------------------------------------------
-------------------------tt---------------------------------------------------------------------------------------------------------------------------
-------------------------tt--------------------------tt---------------------------------------------------------------------------------------------F-
-M-----------------------tt------K-----------------k-ttr--------------------------------------------------------------------------------------------#-
XXXXX---XXXXXXXXXXX---XXXXXXXXXXXXXXXXXXXXX-----XXXXXXXXXXXX---XXXXXXX-----XXXXXXXXX---XXXXXXX-----XXXXXXXXXXXXXXXXXXXXXXXXXXXXXXXXXXXXXXXXXXXXXXXXXXX
XXXXX---XXXXXXXXXXX---XXXXXXXXXXXXXXXXXXXXX-----XXXXXXXXXXXX---XXXXXXX-----XXXXXXXXX---XXXXXXX-----XXXXXXXXXXXXXXXXXXXXXXXXXXXXXXXXXXXXXXXXXXXXXXXXXXX
