------------------------------------------------------------------------------------------------------------------------------------------------------
------------------------------------------------------------------------------------------------------------------------------------------------------
------------------------------------------------------------------------------------------------------------------------------------------------------
------------------------------------------------------------------------------------------------------------------------------------------------------
------------------------------------------------------------------------------------------------------------------------------------------------------
------------------------------------------------------------------------------------------------------------------------------------------------------
------------------------------------------------------------------------------------------------------------------------------------------------------
------------------------------------------------------------------------------------------------------------------------------------------------------
------------------------------------------------------------------------------------------------------------------------------------------------------
---------------------------------------------------------L@@L-----------------------------------------------------------------------------------------
---tt-CC---------------------------------------------tt-----------------------------------------------------------------------------------------------
---tt------------------------------------------------tt------------------------------------------------------------------------U!U--------------------
---tt------------------------------------------------tt---------------------------------------------------------------------TT----------------------F-
-M-tt---y----------------------------------------yy--tt----------r-------------------------------------------------------r--TTg---------------------#-
XXXXXXXXXXXXX-----XXXXXXXXXXXXXXX----XXXXXXX-----XXXXXXXXXXXXXXXXXX----XXXXXX-----XXXXXXXXXX---XXXXXXXXXXXXXXXXXXXX---XXXXXXXXXXXXXXXXXXXXXXX----XXXXX
XXXXXXXXXXXXX-----XXXXXXXXXXXXXXX----XXXXXXX-----XXXXXXXXXXXXXXXXXX----XXXXXX-----XXXXXXXXXX---XXXXXXXXXXXXXXXXXXXX---XXXXXXXXXXXXXXXXXXXXXXX----XXXXX
