------------------------------------------------------------------------------------------------------------------------------------------------------
------------------------------------------------------------------------------------------------------------------------------------------------------
------------------------------------------------------------------------------------------------------------------------------------------------------
------------------------------------------------------------------------------------------------------------------------------------------------------
------------------------------------------------------------------------------------------------------------------------------------------------------
------------------------------------------------------------------------------------------------------------------------------------------------------
------------------------------------------------------------------------------------------------------------------------------------------------------
------------------------------------------------------------------------------------------------------------------------------------------------------
------------------------------------------------------------------------------------------------------------------------------------------------------
--------tt--------------------------------------------------------------------------------------------------------------------------------------------
--------tt-------------------------------------------------------------------------------------------tt-----------------------------------------------
--@@----tt---------------------------------TT-----------------------TT------------tt-----------------tt-----------------------------------------------
--------tt---------------------------------TT-----------------------TT------------tt-----------------tt----------------TT---------------------------F-
-M------tt--------rr-------------------kkk-TT---y----------------gg-TT--ggg-----ggtt--kk-------------tt----yyy----g----TT------------------------yy-#-
XXXXXXXXXXXXXXXXXXXXXXXXXXXXXXXXX-----XXXXXXXXXXXXX----XXXXX----XXXXXXXXXXX---XXXXXXXXXXXXXXXX----XXXXXXXXXXXX---XXXXXXXXXXXXXXXXXXXXXXXXXXXXXXXXXXXXX
XXXXXXXXXXXXXXXXXXXXXXXXXXXXXXXXX-----XXXXXXXXXXXXX----XXXXX----XXXXXXXXXXX---XXXXXXXXXXXXXXXX----XXXXXXXXXXXX---XXXXXXXXXXXXXXXXXXXXXXXXXXXXXXXXXXXXX
