------------------------------------------------------------------------------------------------------------------------------------------------------
------------------------------------------------------------------------------------------------------------------------------------------------------
------------------------------------------------------------------------------------------------------------------------------------------------------
------------------------------------------------------------------------------------------------------------------------------------------------------
------------------------------------------------------------------------------------------------------------------------------------------------------
------------------------------------------------------------------------------------------------------------------------------------------------------
------------------------------------------------------------------------------------------------------------------------------------------------------
------------------------------------------------------------------------------------------------------------------------------------------------------
------------------------------------------------------------------------------------------------------------------------------------------------------
---------------------------------------------tt-------------------------------------------------------------------------------------------------------
---------------------------tt----------------tt--------------------------------------------------------------------LUUL-------------------------------
---------------------------tt----------------tt---------------------------------------------------------------tt--------------------------------------
---------------------------tt----------------tt---------------------------------------------------------------tt------------------------------------F-
-M-------------------------tt-----K-----YYY--tt----------------g------------------------------------------ggg-tt---------YYY------------------------#-
XXXXXXXX-----XXXXXX-----XXXXXXXXXXX---XXXXXXXXXXXXXXXXXXXXXXXXXXXX---XXXXXXXXXX----XXXXXXXXXXXXXXXXXXX---XXXXXXXXXXXXXXXXXXXXX---XXXX----XXXXXX--XXXXX
XXXXXXXX-----XXXXXX-----XXXXXXXXXXX---XXXXXXXXXXXXXXXXXXXXXXXXXXXX---XXXXXXXXXX----XXXXXXXXXXXXXXXXXXX---XXXXXXXXXXXXXXXXXXXXX---XXXX----XXXXXX--XXXXX
