------------------------------------------------------------------------------------------------------------------------------------------------------
------------------------------------------------------------------------------------------------------------------------------------------------------
------------------------------------------------------------------------------------------------------------------------------------------------------
------------------------------------------------------------------------------------------------------------------------------------------------------
------------------------------------------------------------------------------------------------------------------------------------------------------
------------------------------------------------------------------------------------------------------------------------------------------------------
------------------------------------------------------------------------------------------------------------------------------------------------------
------------------------------------------------------------------------------------------------------------------------------------------------------
------------------------------------------------------------------------------------------------------------------------------------------------------
---------------tt------------------------tt-----------------------------------------------------------------------------------------------------------
---------------tt------------------------tt-------------------------------------------------------------TT--------------------------------------------
---------------tt------------------------tt--!!---------------------------------------------------------TT--------------------------------------------
---------------tt------------------------tt-------------------------------------------------------------TT------------------------------------------F-
-M-------------tt-----yyy-------------gggtt--y--------------------------------------------------------ggTT--------k---------------------------------#-
XXXXXXX-----XXXXXXXXXXX---XXXXXXX---XXXXXXXXXXXXXXXXX-----XXXXXXXXXXXXXX---XXXXXXXXXXXXXXXXXX----XXXXXXXXXXXXXXXXXXXX-----XXXXXXX----XXXXXXXX----XXXXX
XXXXXXX-----XXXXXXXXXXX---XXXXXXX---XXXXXXXXXXXXXXXXX-----XXXXXXXXXXXXXX---XXXXXXXXXXXXXXXXXX----XXXXXXXXXXXXXXXXXXXX-----XXXXXXX----XXXXXXXX----XXXXX
