------------------------------------------------------------------------------------------------------------------------------------------------------
------------------------------------------------------------------------------------------------------------------------------------------------------
------------------------------------------------------------------------------------------------------------------------------------------------------
------------------------------------------------------------------------------------------------------------------------------------------------------
------------------------------------------------------------------------------------------------------------------------------------------------------
------------------------------------------------------------------------------------------------------------------------------------------------------
------------------------------------------------------------------------------------------------------------------------------------------------------
------------------------------------------------------------------------------------------------------------------------------------------------------
------------------------------------------------------------------------------------------------------------------------------------------------------
----------------------------------------------------------------------------UU------------------------------------------------------------------------
-----------------------------------------------tt----UU-----------------------------------------------------------------------------------------------
-----------------------------------------------tt----------------------tt-----------------------------------------tt----------------------------------
-----------------------------------------------tt----------------------tt-----------------------------------------tt--------------------------------F-
-M---------------------------------------------tt---KK---------------ggttgg-----------------------------------yy--tt--kkk---------------------------#-
XXXXXXXXX----XXXXXX---XXXXXXXXXXXXXXXX----XXXXXXXXXXXXXXXXXXX-----XXXXXXXXXXXXXXXX---XXXXXXX-----XXXXXXXXXX---XXXXXXXXXXXXXXXXXXXX----XXXXXXXXX--XXXXX
XXXXXXXXX----XXXXXX---XXXXXXXXXXXXXXXX----XXXXXXXXXXXXXXXXXXX-----XXXXXXXXXXXXXXXX---XXXXXXX-----XXXXXXXXXX---XXXXXXXXXXXXXXXXXXXX----XXXXXXXXX--XXXXX
