------------------------------------------------------------------------------------------------------------------------------------------------------
------------------------------------------------------------------------------------------------------------------------------------------------------
------------------------------------------------------------------------------------------------------------------------------------------------------
------------------------------------------------------------------------------------------------------------------------------------------------------
------------------------------------------------------------------------------------------------------------------------------------------------------
------------------------------------------------------------------------------------------------------------------------------------------------------
------------------------------------------------------------------------------------------------------------------------------------------------------
------------------------------------------------------------------------------------------------------------------------------------------------------
------------------------------------------------------------------------------------------------------------------------------------------------------
---------------------------------------------------------------------------tt---------------------------tt--------------------------------------------
---------------------------------------------------------------------------tt---------------------------tt--------------------------------------------
---------------------------tt---!------------------------------------------tt---------------------------tt--LL----------------------------------------
---------------------------tt----------------------------------------------tt---------------------------tt------------------------------------------F-
-M-------------------------tt--yyy-----------------------------------------tt------kkk--------------kk--tt---G--------------------------------------#-
XXXXX-----XXXXXXXXXX---XXXXXXXXXXXXXXXX---XXXXXXX-----XXXXXXXXXXXXX-----XXXXXXXXXXXX-----XXXXXXX---XXXXXXXXXXXXXXXXXX----XXXXXX---XXXXXXXXX-----XXXXXX
XXXXX-----XXXXXXXXXX---XXXXXXXXXXXXXXXX---XXXXXXX-----XXXXXXXXXXXXX-----XXXXXXXXXXXX-----XXXXXXX---XXXXXXXXXXXXXXXXXX----XXXXXX---XXXXXXXXX-----XXXXXX
