------------------------------------------------------------------------------------------------------------------------------------------------------
------------------------------------------------------------------------------------------------------------------------------------------------------
------------------------------------------------------------------------------------------------------------------------------------------------------
------------------------------------------------------------------------------------------------------------------------------------------------------
------------------------------------------------------------------------------------------------------------------------------------------------------
------------------------------------------------------------------------------------------------------------------------------------------------------
------------------------------------------------------------------------------------------------------------------------------------------------------
------------------------------------------------------------------------------------------------------------------------------------------------------
------------------------------------------------------------------------------------------------------------------------------------------------------
-----------------------------------------------------------------------------------------------------LL-----------------------------------------------
--------tt--@@----------------------------------------------------------------------------------------------------------------------------------------
--------tt----------------------------------------------------------------------------------------tt-----------------TT-------------------------------
--------tt----------------------------------------------------------------------------------------tt-----------------TT-----------------------------F-
-M------tt------------------rr--------------------------------------------------------------------ttkkk------------ggTT---kk------------------------#-
XXXXXXXXXXXXXXXXXXXXXXXXXXXXX----XXXXXXXXXXX----XXXX---XXXXXXXX-----XXXXXXXXX-----XXXXXXXXX----XXXXXXXXXXXXX-----XXXXXXXXXXXXXX---XXXXXXXXX---XXXXXXXX
XXXXXXXXXXXXXXXXXXXXXXXXXXXXX----XXXXXXXXXXX----XXXX---XXXXXXXX-----XXXXXXXXX-----XXXXXXXXX----XXXXXXXXXXXXX-----XXXXXXXXXXXXXX---XXXXXXXXX---XXXXXXXX
