------------------------------------------------------------------------------------------------------------------------------------------------------
------------------------------------------------------------------------------------------------------------------------------------------------------
------------------------------------------------------------------------------------------------------------------------------------------------------
------------------------------------------------------------------------------------------------------------------------------------------------------
------------------------------------------------------------------------------------------------------------------------------------------------------
------------------------------------------------------------------------------------------------------------------------------------------------------
------------------------------------------------------------------------------------------------------------------------------------------------------
------S-----------------------------------------------------------------------------------------------------------------------------------------------
------------------------------------------------------------------------------------------------------------------------------------------------------
------------------------------------------------------------------------------------------------------------------------------------------------------
---------------------------------------------------------------------------------------------------------------------------tt-------------------------
------SS-------------------------------------------------------------------------------------------------------------------tt-------------------------
---tt-------------------------------------------------------------------TT-------------------------------------------------tt-----------------------F-
-M-tt---k-------------------------------------------------------------kkTT--------------gg--------------------------rr-----tt----------r------------#-
XXXXXXXXXXXXXXX---XXXXXXX-----XXXXXXXXXXXXXXX----XXXXXXXXXXXXXX----XXXXXXXXXXXXXXXXXXXXXXXXXXXXXXXXX-----XXXXXXXX---XXXXXXXXXXXXXXXXXXXXXXXXXXXXXXXXXX
XXXXXXXXXXXXXXX---XXXXXXX-----XXXXXXXXXXXXXXX----XXXXXXXXXXXXXX----XXXXXXXXXXXXXXXXXXXXXXXXXXXXXXXXX-----XXXXXXXX---XXXXXXXXXXXXXXXXXXXXXXXXXXXXXXXXXX
