------------------------------------------------------------------------------------------------------------------------------------------------------
------------------------------------------------------------------------------------------------------------------------------------------------------
------------------------------------------------------------------------------------------------------------------------------------------------------
------------------------------------------------------------------------------------------------------------------------------------------------------
------------------------------------------------------------------------------------------------------------------------------------------------------
------------------------------------------------------------------------------------------------------------------------------------------------------
------------------------------------------------------------------------------------------------------------------------------------------------------
------------------------------------------------------------------------------------------------------------------------------------------------------
------------------------------------------------------------------------------------------------------------------------------------------------------
----------------------------------------------------------------SS--------------------tt--------------------------------------------------------------
--------------------------------------------------------------------------------------tt---------------------------------------------TT---------------
--------------------------------------------------------------------------------------tt---------------------------------------------TT---------------
----------------------------------------------------------TT--------------------------tt---------------------------------------------TT-------------F-
-M--------------------------------------------------------TT-----k-----------------rr-tt---rrr---------------------------------------TT-r-----------#-
XXXXXXXXX----XXXXXXX-----XXXXXXXXX---XXXXXXXXXXX---XXXXXXXXXXXXXXXXXXXXXXXXXXXX---XXXXXXXXXXXXX-----XXXXX-----XXXXX----XXXXXXXX---XXXXXXXXXXXXX--XXXXX
XXXXXXXXX----XXXXXXX-----XXXXXXXXX---XXXXXXXXXXX---XXXXXXXXXXXXXXXXXXXXXXXXXXXX---XXXXXXXXXXXXX-----XXXXX-----XXXXX----XXXXXXXX---XXXXXXXXXXXXX--XXXXX
