------------------------------------------------------------------------------------------------------------------------------------------------------
------------------------------------------------------------------------------------------------------------------------------------------------------
------------------------------------------------------------------------------------------------------------------------------------------------------
------------------------------------------------------------------------------------------------------------------------------------------------------
------------------------------------------------------------------------------------------------------------------------------------------------------
------------------------------------------------------------------------------------------------------------------------------------------------------
------------------------------------------------------------------------------------------------------------------------------------------------------
------------------------------------------------------------------------------------------------------------------------------------------------------
------------------------------------------------------------------------------------------------------------------------------------------------------
----------------tt------------------------------------------------------------------------------------------------------------------------------------
----------------tt-------------------------------------------------------------------tt---------------------------------------------------------------
----------------tt---SS--------------------------------------------------------------tt---------------------------------------------------------------
----------------tt-------------------------------------------------------------------tt-------------------------------------------------------------F-
-M--------------tt-------k-------------------------------------------------------g---ttggg----------------------------------------------------------#-
XXXXXXXX---XXXXXXXXXXXXXXXXXXX-----XXXXXXXX---XXXXXXXXXXXXXX---XXXXXXXXXX-----XXXXXXXXXXXXXXXXXXXXX----XXXXXXXXXX---XXXXXXX----XXXXXXXXXXXXXXXXXXXXXXX
XXXXXXXX---XXXXXXXXXXXXXXXXXXX-----XXXXXXXX---XXXXXXXXXXXXXX---XXXXXXXXXX-----XXXXXXXXXXXXXXXXXXXXX----XXXXXXXXXX---XXXXXXX----XXXXXXXXXXXXXXXXXXXXXXX
