------------------------------------------------------------------------------------------------------------------------------------------------------
------------------------------------------------------------------------------------------------------------------------------------------------------
------------------------------------------------------------------------------------------------------------------------------------------------------
------------------------------------------------------------------------------------------------------------------------------------------------------
------------------------------------------------------------------------------------------------------------------------------------------------------
------------------------------------------------------------------------------------------------------------------------------------------------------
------------------------------------------------------------------------------------------------------------------------------------------------------
------------------------------------------------------------------------------------------------------------------------------------------------------
------------------------------------------------------------------------------------------------------------------------------------------------------
------------------------------------------------------------------------------------------------------------------------------------------------------
----------------------------------LL-----------------------------------------------------------------------------------------------TT-----------------
------------------------------TT--------------------TT-----------------------------------------------------------------------------TT-----!!----------
------------------------------TT--------------------TT-----------------------------------------------------------------------------TT---------------F-
-M----------------------------TT---r-----------k----TT---rr----------------------------------------------------------------rr------TT-------rr------#-
XXXXXXXXXX----XXXXXXX----XXXXXXXXXXXXXXXXXX----XXXXXXXXXXXX-----XXXXXXXXXXXXXXXXXXXXX----XXXXX-----XXXXXX-----XXXXXXXX-----XXXXXXXXXXXXXXXXXXXXXXXXXXX
XXXXXXXXXX----XXXXXXX----XXXXXXXXXXXXXXXXXX----XXXXXXXXXXXX-----XXXXXXXXXXXXXXXXXXXXX----XXXXX-----XXXXXX-----XXXXXXXX-----XXXXXXXXXXXXXXXXXXXXXXXXXXX
