------------------------------------------------------------------------------------------------------------------------------------------------------
------------------------------------------------------------------------------------------------------------------------------------------------------
------------------------------------------------------------------------------------------------------------------------------------------------------
------------------------------------------------------------------------------------------------------------------------------------------------------
------------------------------------------------------------------------------------------------------------------------------------------------------
------------------------------------------------------------------------------------------------------------------------------------------------------
------------------------------------------------------------------------------------------------------------------------------------------------------
------------------------------------------------------------------------------------------------------------------------------------------------------
------------------------------------------------------------------------------------------------------------------------------------------------------
---------------------------------------------------------@------------------------------------------------------tt--LL--------------------------------
----------------------------------------------------------------tt-----------y----------------------------------tt------------------------------------
--------------------------------------------tt------------------tt-------SLUC!CULS------------------------------tt------------------------------------
--------------------------------------------tt------------------tt----------------------------------------------tt----------------------------------F-
-M------------------------------------------tt----gg---------yy-tt-----kkk--------------------------------------tt----G-----------------------------#-
XXXXXX----XXXXXXXXXX----XXXXXXXXXX-----XXXXXXXXXXXX-----XXXXXXXXXXXXXXXXXXXXXXXXXXXXXXXXXXXXXXXXXXXXXXXX-----XXXXXXXXXXXXX----XXXXXXXXXXX----XXXXXXXXX
XXXXXX----XXXXXXXXXX----XXXXXXXXXX-----XXXXXXXXXXXX-----XXXXXXXXXXXXXXXXXXXXXXXXXXXXXXXXXXXXXXXXXXXXXXXX-----XXXXXXXXXXXXX----XXXXXXXXXXX----XXXXXXXXX
