------------------------------------------------------------------------------------------------------------------------------------------------------
------------------------------------------------------------------------------------------------------------------------------------------------------
------------------------------------------------------------------------------------------------------------------------------------------------------
------------------------------------------------------------------------------------------------------------------------------------------------------
------------------------------------------------------------------------------------------------------------------------------------------------------
------------------------------------------------------------------------------------------------------------------------------------------------------
------------------------------------------------------------------------------------------------------------------------------------------------@-----
------------------------------------------------------------------------------------------------------------------------------------------------------
------------------------------------------------------------------------------------------------------------------------------------------------------
--------------------------------------------------------------------------------------------------------------------------------------------tt--SS----
------------------------------------------------------------------------------------------------------------TT-!----------------------------tt--------
------------------------------------------------------------------------------------------------------------TT------------------------------tt--------
------------------------------------------------------------------------------------------------------------TT------------------------------tt------F-
-M----------------------------------------------------------------------------------------------------------TT---yy-----------------------rrtt-----r#-
XXXXXXXXX----XXXXXXX---XXXXXXXXX-----XXXXXXXXXXXXXXXXXXXX---XXXXXX----XXXXX---XXXXXXXXXXX----XXXXXXXX----XXXXXXXXXXXXX----XXXXXXXXXX---XXXXXXXXXXXXXXX
XXXXXXXXX----XXXXXXX---XXXXXXXXX-----XXXXXXXXXXXXXXXXXXXX---XXXXXX----XXXXX---XXXXXXXXXXX----XXXXXXXX----XXXXXXXXXXXXX----XXXXXXXXXX---XXXXXXXXXXXXXXX
