------------------------------------------------------------------------------------------------------------------------------------------------------
------------------------------------------------------------------------------------------------------------------------------------------------------
------------------------------------------------------------------------------------------------------------------------------------------------------
------------------------------------------------------------------------------------------------------------------------------------------------------
------------------------------------------------------------------------------------------------------------------------------------------------------
------------------------------------------------------------------------------------------------------------------------------------------------------
------------------------------------------------------------------------------------------------------------------------------------------------------
------------------------------------------------------------------------------------------------------------------------------------------------------
------------------------------------------------------------------------------------------------------------------------------------------------------
-------S-S------------tt-----------------------------------------------------USU----------------------------------------------------------------------
----tt----------------tt----------------------------------tt------------------------------------------------------------------------------------------
----tt----------------tt----------------------------------tt------------------------------------------------------------------------------------------
----tt----------------tt----------------------------------tt--------------tt-----------------tt-----------------------------------------------------F-
-M--tt-------rr-------tt--------------------r---------rrr-ttkkk--------RR-tt----yyy----------tt--r--------------------------------------------------#-
XXXXXXXXXXXXXXX----XXXXXXXXXXXXXXXXXXXXXXXXXXXXXXX---XXXXXXXXXXXX-----XXXXXXXXXXXXXXX-----XXXXXXXXXXX---XXXXX---XXXXXXXXXXXXXXXXXXXXXXXXXXXX-----XXXXX
XXXXXXXXXXXXXXX----XXXXXXXXXXXXXXXXXXXXXXXXXXXXXXX---XXXXXXXXXXXX-----XXXXXXXXXXXXXXX-----XXXXXXXXXXX---XXXXX---XXXXXXXXXXXXXXXXXXXXXXXXXXXX-----XXXXX
