------------------------------------------------------------------------------------------------------------------------------------------------------
------------------------------------------------------------------------------------------------------------------------------------------------------
------------------------------------------------------------------------------------------------------------------------------------------------------
------------------------------------------------------------------------------------------------------------------------------------------------------
------------------------------------------------------------------------------------------------------------------------------------------------------
------------------------------------------------------------------------------------------------------------------------------------------------------
------------------------------------------------------------------------------------------------------------------------------------------------------
------------------------------------------------------------------------------------------------------------------------------------------------------
------------------------------------------------------------------------------------------------------------------------------------------------------
--------------------------------------------------------------------------------------------------------------------------tt----------------@@--------
---------------tt------------------------------------------------------------------------tt-------------------------------tt--------------------------
---------------tt------------------------------------------------------------------------tt-----------tt------------------tt-------------tt-----------
---------------tt------------------------------------------------------tt----------------tt-----------tt------------------tt-------------tt---------F-
-M-------------tt--rrr-------------------------------------------------tt---KKK------RR--tt---KKK-----tt----rrr-----------tt--rrr--------tt---GGG---#-
XXXXXXX----XXXXXXXXXXX---XXXXXXX-----XXXXXXXXXXXXXX----XXXXXXXXX----XXXXXXXXXXXXX----XXXXXXXXXXX---XXXXXXXXXXXXXXXXX---XXXXXXXXXXX----XXXXXXXXXXXXXXXX
XXXXXXX----XXXXXXXXXXX---XXXXXXX-----XXXXXXXXXXXXXX----XXXXXXXXX----XXXXXXXXXXXXX----XXXXXXXXXXX---XXXXXXXXXXXXXXXXX---XXXXXXXXXXX----XXXXXXXXXXXXXXXX
