------------------------------------------------------------------------------------------------------------------------------------------------------
------------------------------------------------------------------------------------------------------------------------------------------------------
------------------------------------------------------------------------------------------------------------------------------------------------------
------------------------------------------------------------------------------------------------------------------------------------------------------
------------------------------------------------------------------------------------------------------------------------------------------------------
------------------------------------------------------------------------------------------------------------------------------------------------------
------------------------------------------------------------------------------------------------------------------------------------------------------
------------------------------------------------------------------------------------------------------------------------------------------------------
------------------------------------------------------------------------------------------------------------------------------------------------------
---------------------------------------------------------------------------------LL------------tt-----------------------------!-!---------------------
-----------------------------------------------------------------------------------------------tt---------------------------------------------tt------
------------------------------------------------------------------------------TT---------------tt---------------------------------------------tt------
------------------------------------------------------------------------------TT---------------tt-------------------------tt------------------tt----F-
-M----------------------------------------------------------------------------TT-----kkk-------tt--kk---------------------tt--y-----------ggg-tt--r-#-
XXXXXXXX---XXXXXXXX----XXXXXXXXXXXXXXX-----XXXXXXXXX----XXXXXXXXXXXXX-----XXXXXXXXXXXXXX----XXXXXXXXXXX-----XXXXXXXX---XXXXXXXXXXXXXXX---XXXXXXXXXXXXX
XXXXXXXX---XXXXXXXX----XXXXXXXXXXXXXXX-----XXXXXXXXX----XXXXXXXXXXXXX-----XXXXXXXXXXXXXX----XXXXXXXXXXX-----XXXXXXXX---XXXXXXXXXXXXXXX---XXXXXXXXXXXXX
