------------------------------------------------------------------------------------------------------------------------------------------------------
------------------------------------------------------------------------------------------------------------------------------------------------------
------------------------------------------------------------------------------------------------------------------------------------------------------
------------------------------------------------------------------------------------------------------------------------------------------------------
------------------------------------------------------------------------------------------------------------------------------------------------------
------------------------------------------------------------------------------------------------------------------------------------------------------
------------------------------------------------------------------------------------------------------------------------------------------------------
------------------------------------------------------------------------------------------------------------------------------------------------------
------------------------------------------------------------------------------------------------------------------------------------------------------
----------------------------------------------------------------------------tt---!!-------------------------------------------------------------------
-------------------------------------------------tt-------------------------tt------------------------------------------------------------------------
---tt--------------------------tt----------------tt--@@---------------------tt------------------------------------------------------------------------
---tt--------------------------tt----------------tt-------------------------tt----------------------------------------------------------------------F-
-M-tt----------yyy-------------tt-------kk----k--ttyyy-------------------RR-tt---------ggg----------------------------------------------------------#-
XXXXXXXXXXXXXXXXXXXXXXXXX---XXXXXXXXXXXXXX---XXXXXXXXXXXXX---XXXXXXX----XXXXXXXXXXXXXXXX---XXXXXXXXXX-----XXXXXXXXXXXXXXXXXXXXXXXXXXXXX----XXXXXXXXXXX
XXXXXXXXXXXXXXXXXXXXXXXXX---XXXXXXXXXXXXXX---XXXXXXXXXXXXX---XXXXXXX----XXXXXXXXXXXXXXXX---XXXXXXXXXX-----XXXXXXXXXXXXXXXXXXXXXXXXXXXXX----XXXXXXXXXXX
