------------------------------------------------------------------------------------------------------------------------------------------------------
------------------------------------------------------------------------------------------------------------------------------------------------------
------------------------------------------------------------------------------------------------------------------------------------------------------
------------------------------------------------------------------------------------------------------------------------------------------------------
------------------------------------------------------------------------------------------------------------------------------------------------------
------------------------------------------------------------------------------------------------------------------------------------------------------
------------------------------------------------------------------------------------------------------------------------------------------------------
------------------------------------------------------------------------------------------------------------------------------------------------------
------------------------------------------------------------------------------------------------------------------------------------------------------
------------------------------------TT----------------------------------------------------------------------------------------------------------------
------------------------------------TT--------------------------------------------------------------------------------TT------------------------------
------------------------------------TT---------------------tt---------------------------------------------------------TT---------------tt--L----------
------------------------------------TT---------------------tt-----------------------------------tt--------------------TT---------------tt-----------F-
-M----------------------------------TT---r-------------yyy-ttg----------------------------k-----tt------ggg-------gg--TTggg---------yyytt-----------#-
XXXXXXXXXX---XXXXXX----XXXXXX----XXXXXXXXXXX-----XXXXXXXXXXXXXXXXXXXXXXXXXXXXXXXXXXXXXX---XXXXXXXXXXXXXXXXXXX-----XXXXXXXXXXXX----XXXXXXXXXXXXXXXXXXXX
XXXXXXXXXX---XXXXXX----XXXXXX----XXXXXXXXXXX-----XXXXXXXXXXXXXXXXXXXXXXXXXXXXXXXXXXXXXX---XXXXXXXXXXXXXXXXXXX-----XXXXXXXXXXXX----XXXXXXXXXXXXXXXXXXXX
