------------------------------------------------------------------------------------------------------------------------------------------------------
------------------------------------------------------------------------------------------------------------------------------------------------------
------------------------------------------------------------------------------------------------------------------------------------------------------
------------------------------------------------------------------------------------------------------------------------------------------------------
------------------------------------------------------------------------------------------------------------------------------------------------------
------------------------------------------------------------------------------------------------------------------------------------------------------
------------------------------------------------------------------------------------------------------------------------------------------------------
------------------------------------------------------------------------------------------------------------------------------------------------------
------------------------------------------------------------------------------------------------------------------------------------------------------
--------------------------tt--------------------------------------------------------------------------------------------------------------------------
--------------------------tt-----------------------------TT-------------------------------------------------------------------------------------------
--------------------------tt-----------------------------TT-------------------------------------------------------------------------------------------
------tt------------------tt-----------------------------TT-----------------------------------------------------------------------------------------F-
-M----tt--------r-----KK--tt--rrr--------------------rr--TT-----rrr---------------------------------------------------------------------------------#-
XXXXXXXXXXXXXXXXX-----XXXXXXXXXXXXXXXXX---XXXXXXX----XXXXXXXXXXXX-----XXXXXXXX----XXXXXXX----XXXXXXXXXXXXXXXXXXXX----XXXXXXXXXXXXXXXXXXXXXXXXX---XXXXX
XXXXXXXXXXXXXXXXX-----XXXXXXXXXXXXXXXXX---XXXXXXX----XXXXXXXXXXXX-----XXXXXXXX----XXXXXXX----XXXXXXXXXXXXXXXXXXXX----XXXXXXXXXXXXXXXXXXXXXXXXX---XXXXX
