------------------------------------------------------------------------------------------------------------------------------------------------------
------------------------------------------------------------------------------------------------------------------------------------------------------
------------------------------------------------------------------------------------------------------------------------------------------------------
------------------------------------------------------------------------------------------------------------------------------------------------------
------------------------------------------------------------------------------------------------------------------------------------------------------
------------------------------------------------------------------------------------------------------------------------------------------------------
------------------------------------------------------------------------------------------------------------------------------------------------------
------------------------------------------------------------------------------------------------------------------------------------------------------
------------------------------------------------------------------------------------------------------------------------------------------------------
---------------------tt-CC-------------------------------------------------------------------------------------------------------tt-------------------
---------------------tt--------------------------------------TT------------------------------------------------------------------tt-------------------
---TT----------------tt--------------------------------------TT------------------------------------------------------------------tt-------------------
---TT----------------tt-----------------tt-------------------TT------------------------------------------------------------------tt-----------------F-
-M-TT----g---------kktt-------rr-----k--tt------rrr----------TT---kk-------------------------------------------------------------tt-----k-----------#-
XXXXXXXXXXXX-----XXXXXXXXXXXXXX-----XXXXXXXXXXXXXXXXX-----XXXXXXXXXXX----XXXXXXXXXXXXXXXXXXXXXXXXXXXXXXXXXXXXXXXXXXXXXXXXX----XXXXXXXXXXXXXXXX---XXXXX
XXXXXXXXXXXX-----XXXXXXXXXXXXXX-----XXXXXXXXXXXXXXXXX-----XXXXXXXXXXX----XXXXXXXXXXXXXXXXXXXXXXXXXXXXXXXXXXXXXXXXXXXXXXXXX----XXXXXXXXXXXXXXXX---XXXXX
