------------------------------------------------------------------------------------------------------------------------------------------------------
------------------------------------------------------------------------------------------------------------------------------------------------------
------------------------------------------------------------------------------------------------------------------------------------------------------
------------------------------------------------------------------------------------------------------------------------------------------------------
------------------------------------------------------------------------------------------------------------------------------------------------------
------------------------------------------------------------------------------------------------------------------------------------------------------
------------------------------------------------------------------------------------------------------------------------------------------------------
------------------------------------------------------------------------------------------------------------------------------------------------------
------------------------------------------------------------------------------------------------------------------------------------------------------
----------------------------------------------------------------------------tt------------------------------------------------------------------------
-------------------------------------------!LL!-----------------------------tt-----------------------------!---------------------------------tt-------
------------------------------------TT-----------------------TT-------------tt---------------------------------------------------------------tt-------
------------------------------------TT-----------------------TT-------------tt-----------------------tt--------------------------------------tt-----F-
-M----------------------------------TT-----ggg---------------TT-----GGG-----tt-----y-------------kk--tt---------------rr---------------------tt----r#-
XXXXXXXX---XXXXXX-----XXXXXX---XXXXXXXXXXXXXXXXXXXXXX-----XXXXXXXXXXX----XXXXXXXXXXXXXXXXXXX-----XXXXXXXXXXXXXXXXXXXXXXXXXX----XXXXXX-----XXXXXXXXXXXX
XXXXXXXX---XXXXXX-----XXXXXX---XXXXXXXXXXXXXXXXXXXXXX-----XXXXXXXXXXX----XXXXXXXXXXXXXXXXXXX-----XXXXXXXXXXXXXXXXXXXXXXXXXX----XXXXXX-----XXXXXXXXXXXX
