------------------------------------------------------------------------------------------------------------------------------------------------------
------------------------------------------------------------------------------------------------------------------------------------------------------
------------------------------------------------------------------------------------------------------------------------------------------------------
------------------------------------------------------------------------------------------------------------------------------------------------------
------------------------------------------------------------------------------------------------------------------------------------------------------
------------------------------------------------------------------------------------------------------------------------------------------------------
------------------------------------------------------------------------------------------------------------------------------------------------------
------------------------------------------------------------------------------------------------------------------------------------------------------
------------------------------------------------------------------------------------------------------------------------------------------------------
---------------------------------------------------------------------------------------------------------TT-------------------------tt----------------
-------------------------------------------------------------------------------ggg-----------------------TT-------------------------tt----------------
------------------------------------------------------------------------tt--CUUUUC-----------------------TT-------------------------tt----------------
-------tt-----------------------------------------------tt--------------tt-------------------------------TT------------tt-----------tt--------------F-
-M-----tt----------rrr----------------------------------tt-g--------gg--tt--------------y-------------rr-TTyy--------ggttyyy--------tt----gg--------#-
XXXXXXXXXXXXXXXXXXXXXXXXXXX----XXXXXXXXXXXXXXXXX-----XXXXXXXXXXX----XXXXXXXXXXXXXXXXXXXXXXXXXXXXX----XXXXXXXXXXX---XXXXXXXXXXX---XXXXXXXXXXXXX---XXXXX
XXXXXXXXXXXXXXXXXXXXXXXXXXX----XXXXXXXXXXXXXXXXX-----XXXXXXXXXXX----XXXXXXXXXXXXXXXXXXXXXXXXXXXXX----XXXXXXXXXXX---XXXXXXXXXXX---XXXXXXXXXXXXX---XXXXX
