------------------------------------------------------------------------------------------------------------------------------------------------------
------------------------------------------------------------------------------------------------------------------------------------------------------
------------------------------------------------------------------------------------------------------------------------------------------------------
------------------------------------------------------------------------------------------------------------------------------------------------------
------------------------------------------------------------------------------------------------------------------------------------------------------
------------------------------------------------------------------------------------------------------------------------------------------------------
------------------------------------------------------------------------------------------------------------------------------------------------------
------------------------------------------------------------------------------------------------------------------------------------------------------
------------------------------------------------------------------------------------------------------------------------------------------------------
----------------------------------------------------------------------TT---------------------------------------------C!!C-----------------------------
----------------------------------------------------------------------TT-----------------------------------tt-----------------------------------------
-----------------------------------tt---------------------------------TT-!C!------------------------CC-----tt-----------------------------------------
-----------------TT----------------tt---------------------------------TT-----------------------------------tt---------------------------------------F-
-M---------------TT---kk------rr---tt--------k----------------------rrTT-yy--------------------------ggg---tt---Y-----------------------------------#-
XXXXXXXXXX----XXXXXXXXXXX----XXXXXXXXXXXXXXXXXXXXXXXXXXXXXXX-----XXXXXXXXXXXXXXXX---XXXXXXXXX----XXXXXXXXXXXXXXXXXXXXXXXXXXXXXXXXXXXXXXX---XXXXX-XXXXX
XXXXXXXXXX----XXXXXXXXXXX----XXXXXXXXXXXXXXXXXXXXXXXXXXXXXXX-----XXXXXXXXXXXXXXXX---XXXXXXXXX----XXXXXXXXXXXXXXXXXXXXXXXXXXXXXXXXXXXXXXX---XXXXX-XXXXX
