------------------------------------------------------------------------------------------------------------------------------------------------------
------------------------------------------------------------------------------------------------------------------------------------------------------
------------------------------------------------------------------------------------------------------------------------------------------------------
------------------------------------------------------------------------------------------------------------------------------------------------------
------------------------------------------------------------------------------------------------------------------------------------------------------
------------------------------------------------------------------------------------------------------------------------------------------------------
------------------------------------------------------------------------------------------------------------------------------------------------------
------------------------------------------------------------------------------------------------------------------------------------------------------
------------------------------------------------------------------------------------------------------------------------------------------------------
-------------------------------------------------------------------------------------------------------------tt---!-!---------------------------------
-------------------------------------------------------------------------------------@UU@--------------------tt---------------------------------------
-------------------------------------------------------------------------------------------------------------tt---------------------------------------
----------------------------------------------------------------------------------tt-------------------------tt-------------------------------------F-
-M--------------------------------------------------------------------------------tt--------r--------------GGttggg----------------------------------#-
XXXXXXXXXXX-----XXXXXXX-----XXXXXXXX----XXXXXXXXXX----XXXXXXXX-----XXXXXXXXX---XXXXXXXXXXXXXXXXXXXXX-----XXXXXXXXXXXXXXX-----XXXXXXX----XXXXXXX--XXXXX
XXXXXXXXXXX-----XXXXXXX-----XXXXXXXX----XXXXXXXXXX----XXXXXXXX-----XXXXXXXXX---XXXXXXXXXXXXXXXXXXXXX-----XXXXXXXXXXXXXXX-----XXXXXXX----XXXXXXX--XXXXX
