------------------------------------------------------------------------------------------------------------------------------------------------------
------------------------------------------------------------------------------------------------------------------------------------------------------
------------------------------------------------------------------------------------------------------------------------------------------------------
------------------------------------------------------------------------------------------------------------------------------------------------------
------------------------------------------------------------------------------------------------------------------------------------------------------
------------------------------------------------------------------------------------------------------------------------------------------------------
------------------------------------------------------------------------------------------------------------------------------------------------------
------------------------------------------------------------------------------------------------------------------------------------------------------
------------------------------------------------------------------------------------------------------------------------------------------------------
----------------------------------------------------------------------------------------------------------------------------------tt------------------
----------------------------------------------------------------------------------------------------------------------------------tt------------------
-----------------------------------------------------------------------------------------@@---------------------------------------tt------------------
---------------------------------------------------------tt---------------------------tt------------------------------------------tt----------------F-
-M-------------------------------------------------------tt--yy---------------------y-tt-gg----------------------------------rr---tt----rr----------#-
XXXXXXXXXXXX---XXXXXX---XXXXXXXXXXXXXXXXXXXXXXXX----XXXXXXXXXXXXX---XXXXXXXXXX---XXXXXXXXXXXXXX----XXXXXXXXXX-----XXXXXX-----XXXXXXXXXXXXXXX---XXXXXXX
XXXXXXXXXXXX---XXXXXX---XXXXXXXXXXXXXXXXXXXXXXXX----XXXXXXXXXXXXX---XXXXXXXXXX---XXXXXXXXXXXXXX----XXXXXXXXXX-----XXXXXX-----XXXXXXXXXXXXXXX---XXXXXXX
