------------------------------------------------------------------------------------------------------------------------------------------------------
------------------------------------------------------------------------------------------------------------------------------------------------------
------------------------------------------------------------------------------------------------------------------------------------------------------
------------------------------------------------------------------------------------------------------------------------------------------------------
------------------------------------------------------------------------------------------------------------------------------------------------------
------------------------------------------------------------------------------------------------------------------------------------------------------
------------------------------------------------------------------------------------------------------------------------------------------------------
------------------------------------------------------------------------------------------------------------------------------------------------------
------------------------------------------------------------------------------------------------------------------------------------------------------
-----------------!!!!--------------SS---------------------------------------------------------------------------------------TT------------------------
----------------------------------------------------------------------------------------------------------------------------TT--!!--------------------
----------------------------------------------------------------------------------------------------------------------------TT------------------------
--------------TT--------------------------tt--------------------------------------------------------------------------------TT----------------------F-
-M------------TT-----gg-----------------kktt---kkk-----------------------------------------------------------------------k--TT-----------kkk--------#-
XXXXX---XXXXXXXXXXXXXXXXXXXXX----XXXXXXXXXXXXXXXXXXXXXXXXXXXXXXXXX---XXXXXXXXXXXXXXXX----XXXXXXXXXXXXX-----XXXXXXXXX----XXXXXXXXXXXXXXXXXX----XXXXXXXX
XXXXX---XXXXXXXXXXXXXXXXXXXXX----XXXXXXXXXXXXXXXXXXXXXXXXXXXXXXXXX---XXXXXXXXXXXXXXXX----XXXXXXXXXXXXX-----XXXXXXXXX----XXXXXXXXXXXXXXXXXX----XXXXXXXX
