------------------------------------------------------------------------------------------------------------------------------------------------------
------------------------------------------------------------------------------------------------------------------------------------------------------
------------------------------------------------------------------------------------------------------------------------------------------------------
------------------------------------------------------------------------------------------------------------------------------------------------------
------------------------------------------------------------------------------------------------------------------------------------------------------
------------------------------------------------------------------------------------------------------------------------------------------------------
------------------------------------------------------------------------------------------------------------------------------------------------------
------------------------------------------------------------------------------------------------------------------------------------------------------
------------------------------------------------------------------------------------------------------------------------------------------------------
------------------------------------------------L-L---------------------------------------------------------------------------------------------------
---------------------------------------------------------------------tt----------------------tt---LL--------------------------------------------------
----tt---------------------------------------------------------------tt----------------------tt-------------------------------------------------------
----tt--------------------------------------tt-----------------------tt----------------------tt-----------------------------------------------------F-
-M--tt-KKK------------------------------kkk-tt-y---------------rrr---tt------------KKK---gg--tt------rr---------------------------------------------#-
XXXXXXXXXXXXXXXXXXXXXX-----XXXXXXX----XXXXXXXXXXXXXXXXXX-----XXXXXXXXXXXXXXXXXXXXXXXXX---XXXXXXXXXXXXXXX---XXXXXXXXXXXXXXXXXXXXXXXXXXX-----XXXXXXXXXXX
XXXXXXXXXXXXXXXXXXXXXX-----XXXXXXX----XXXXXXXXXXXXXXXXXX-----XXXXXXXXXXXXXXXXXXXXXXXXX---XXXXXXXXXXXXXXX---XXXXXXXXXXXXXXXXXXXXXXXXXXX-----XXXXXXXXXXX
