------------------------------------------------------------------------------------------------------------------------------------------------------
------------------------------------------------------------------------------------------------------------------------------------------------------
------------------------------------------------------------------------------------------------------------------------------------------------------
------------------------------------------------------------------------------------------------------------------------------------------------------
------------------------------------------------------------------------------------------------------------------------------------------------------
------------------------------------------------------------------------------------------------------------------------------------------------------
------------------------------------------------------------------------------------------------------------------------------------------------------
------------------------------------------------------------------------------------------------------------------------------------------------------
------------------------------------------------------------------------------------------------------------------------------------------------------
--------------------------------------------------------------------------------------------------C-C-------------------------------------------------
-----------------------------------------------------------------------S!!S-----------------tt--------------------------------------------------------
-----TT----------------------------------------------------------tt-------------------------tt--------------------------------------------------------
-----TT-----------------tt-------------tt------------------------tt-------------------------tt------------------------------------------------------F-
-M---TT-----g-------K---tt----g--------ttr---------------------g-tt--------g------------g---tt----------kk------------------------------------------#-
XXXXXXXXXXXXXX-----XXXXXXXXXXXXX----XXXXXXXXXXXXXXXXXX-----XXXXXXXXXXXXXXXXXXXXXXX-----XXXXXXXXXXXXXXXXXXXXXX---XXXXXXXXXX-----XXXXXX----XXXXXX--XXXXX
XXXXXXXXXXXXXX-----XXXXXXXXXXXXX----XXXXXXXXXXXXXXXXXX-----XXXXXXXXXXXXXXXXXXXXXXX-----XXXXXXXXXXXXXXXXXXXXXX---XXXXXXXXXX-----XXXXXX----XXXXXX--XXXXX
