------------------------------------------------------------------------------------------------------------------------------------------------------
------------------------------------------------------------------------------------------------------------------------------------------------------
------------------------------------------------------------------------------------------------------------------------------------------------------
------------------------------------------------------------------------------------------------------------------------------------------------------
------------------------------------------------------------------------------------------------------------------------------------------------------
------------------------------------------------------------------------------------------------------------------------------------------------------
------------------------------------------------------------------------------------------------------------------------------------------------------
--------------------------------------!CC!------------------------------------------------------------------------------------------------------------
------------------------------------------------------------------------------------------------------------------------------------------------------
----tt-------------------------------kk----------------------------tt---------------------------------------------------------------------------------
----tt--S!!S---------------tt-------CS@LL@SC-----------------------tt----S!!S-------------------------------------------------------------------------
----tt---------------------tt--------------------------------------tt--------------------tt-----------------------------------------------------------
----tt---------------------tt--------------------------------------tt--------------------tt---------------------------------------------------------F-
-M--tt--------------yy-----tt---------------------kkk---------r----tt-----RRR----------yytt----ggg--------------------------------------------------#-
XXXXXXXXXXXXXXXXXXXXX---XXXXXXXXXXXXXXXXXXXXXXXXXXXXXXXXXX---XXXXXXXXXXXXXXXXXXXX---XXXXXXXXXXXXXXXX---XXXXXX---XXXXXXXXXXXXXXXXXXXXXXXXXXXXXXXXXXXXXX
XXXXXXXXXXXXXXXXXXXXX---XXXXXXXXXXXXXXXXXXXXXXXXXXXXXXXXXX---XXXXXXXXXXXXXXXXXXXX---XXXXXXXXXXXXXXXX---XXXXXX---XXXXXXXXXXXXXXXXXXXXXXXXXXXXXXXXXXXXXX
