------------------------------------------------------------------------------------------------------------------------------------------------------
------------------------------------------------------------------------------------------------------------------------------------------------------
------------------------------------------------------------------------------------------------------------------------------------------------------
------------------------------------------------------------------------------------------------------------------------------------------------------
------------------------------------------------------------------------------------------------------------------------------------------------------
------------------------------------------------------------------------------------------------------------------------------------------------------
------------------------------------------------------------------------------------------------------------------------------------------------------
------------------------------------------------------------------------------------------------------------------------------------------------------
------------------------------------------------------------------------------------------------------------------------------------------------------
---------------------tt--------------------tt---------------------------------------------------------------------------------------------------------
---------------------tt--------------------tt---------------------------------------------------------------------------------------------------------
----tt---------------tt--------------------tt-SS---------------------------------------------------------------------------------tt-------------------
----tt---------------tt--------------------tt------------------------------------------------------------------------------------tt-----------------F-
-M--tt-----rr----gg--tt-----------r----rr--tt---kk---------------------------------------------------------------------------yy--tt------rrr--------#-
XXXXXXXXXXXXX---XXXXXXXXXXXXXXXXXXX----XXXXXXXXXXXXXXXX-----XXXXXXXXXX---XXXXXXXXX---XXXXXXXXXXX-----XXXXXX-----XXXXXXXXX----XXXXXXXXXXXXXXXXXXX-XXXXX
XXXXXXXXXXXXX---XXXXXXXXXXXXXXXXXXX----XXXXXXXXXXXXXXXX-----XXXXXXXXXX---XXXXXXXXX---XXXXXXXXXXX-----XXXXXX-----XXXXXXXXX----XXXXXXXXXXXXXXXXXXX-XXXXX
