------------------------------------------------------------------------------------------------------------------------------------------------------
------------------------------------------------------------------------------------------------------------------------------------------------------
------------------------------------------------------------------------------------------------------------------------------------------------------
------------------------------------------------------------------------------------------------------------------------------------------------------
------------------------------------------------------------------------------------------------------------------------------------------------------
------------------------------------------------------------------------------------------------------------------------------------------------------
------------------------------------------------------------------------------------------------------------------------------------------------------
------------------------------------------------------------------------S-----------------------------------------------------------------------------
------------------------------------------------------------------------------------------------------------------------------------------------------
-------------------------------------tt------------------------------tt-------------------------------------------------------------------------------
-------------------------------------tt--C-C-----------tt------------tt-@@----------------------------------------------------------------------------
-------------------------------------tt----------------tt------------tt----------------------------------------------------------------------tt-------
-------------------------------------tt----------------tt------------tt----------------------------------------------------------------------tt-----F-
-M-----------------------------------tt---yyy-------gg-tt-rr-----rr--tt--r-------------------------------------------------------------------tt-----#k
XXXXXXXX----XXXXXXXXXXXXXXXXX----XXXXXXXXXXXXXXX---XXXXXXXXXXX---XXXXXXXXXXXXXX---XXXX---XXXXX---XXXXXXXXXXXXXXXXXXXXXXXXX---XXXXXXXXXX---XXXXXXXXXXXX
XXXXXXXX----XXXXXXXXXXXXXXXXX----XXXXXXXXXXXXXXX---XXXXXXXXXXX---XXXXXXXXXXXXXX---XXXX---XXXXX---XXXXXXXXXXXXXXXXXXXXXXXXX---XXXXXXXXXX---XXXXXXXXXXXX
