------------------------------------------------------------------------------------------------------------------------------------------------------
------------------------------------------------------------------------------------------------------------------------------------------------------
------------------------------------------------------------------------------------------------------------------------------------------------------
------------------------------------------------------------------------------------------------------------------------------------------------------
------------------------------------------------------------------------------------------------------------------------------------------------------
------------------------------------------------------------------------------------------------------------------------------------------------------
------------------------------------------------------------------------------------------------------------------------------------------------------
------------------------------------------------------------------------------------------------------------------------------------------------------
---------------------yyy------------------------------------------------------------------------------------------------------------------------------
------------LLUL@U-U@LULL---------------------------------------------------------------tt------------------------------------------------------------
--SS------------------------------------------------------------------------------------tt------------------------------------------------------------
----------------------------------------------------------------------------------------tt------------------------------------------------------------
--------tt------------------------------------------------------------------------------tt------------------------------------tt--------------------F-
-M------tty--------------------------------------------------------------------------kk-tt----------gg------------------------tt--k-----------------#-
XXXXXXXXXXXXXXXXXXXXXXXXXXXXXXXXXXXXXXXXXXXXXXXXXXXXXXX-----XXXXXXXXXXXXXXXXX-----XXXXXXXXXXXXXXXXXXXXXXXXXXXXXXXXXXXX-----XXXXXXXXXXX-----XXXXXXXXXXX
XXXXXXXXXXXXXXXXXXXXXXXXXXXXXXXXXXXXXXXXXXXXXXXXXXXXXXX-----XXXXXXXXXXXXXXXXX-----XXXXXXXXXXXXXXXXXXXXXXXXXXXXXXXXXXXX-----XXXXXXXXXXX-----XXXXXXXXXXX
