------------------------------------------------------------------------------------------------------------------------------------------------------
------------------------------------------------------------------------------------------------------------------------------------------------------
------------------------------------------------------------------------------------------------------------------------------------------------------
------------------------------------------------------------------------------------------------------------------------------------------------------
------------------------------------------------------------------------------------------------------------------------------------------------------
------------------------------------------------------------------------------------------------------------------------------------------------------
------------------------------------------------------------------------------------------------------------------------------------------------------
------------------------------------------------------------------------------------------------------------------------------------------------------
------------------------------------------------------------------------------------------------------------------------------------------------------
------------------------------------------------------------------------------------------------------------------------------------------------------
---------------tt----LL------------------------------------------@@------------tt---------------------------------------------------------------------
---------------tt---------------------------------------------TT---------------tt---------------------------------------------------------------------
---------------tt-------------------------tt------------------TT---------------tt-------------------------------------------------------------------F-
-M-------------tt----------------k------rrtt------k-------rr--TT-----r-------rrtt----------yyy------------------------------------------------------#-
XXXXXXX---XXXXXXXXXXXXXXXXXXXXXXXX----XXXXXXXXXXXXXXXXX---XXXXXXXXXXXXX----XXXXXXXXXXXXXXXXXXXXXXXX----XXXXXXXXX---XXXXXXX---XXXXXXXXXXXXX----XXXXXXXX
XXXXXXX---XXXXXXXXXXXXXXXXXXXXXXXX----XXXXXXXXXXXXXXXXX---XXXXXXXXXXXXX----XXXXXXXXXXXXXXXXXXXXXXXX----XXXXXXXXX---XXXXXXX---XXXXXXXXXXXXX----XXXXXXXX
