------------------------------------------------------------------------------------------------------------------------------------------------------
------------------------------------------------------------------------------------------------------------------------------------------------------
------------------------------------------------------------------------------------------------------------------------------------------------------
------------------------------------------------------------------------------------------------------------------------------------------------------
------------------------------------------------------------------------------------------------------------------------------------------------------
------------------------------------------------------------------------------------------------------------------------------------------------------
------------------------------------------------------------------------------------------------------------------------------------------------------
------------------------------------------------------------------------------------------------------------------------------------------------------
------------------------------------------------------------------------------------------------------------------------------------------------------
---------------------------------------------------------------------tt-------------------------------------------------------------------------------
---------------------------------------------tt----------------------tt-----------------------------------------------------------------!-!-----------
------------CC-------------------------------tt---@@-----------------tt-------------------------------------------------------------------------------
-----tt--------------------------------------tt----------------------tt------------------------------------------------------------tt---------------F-
-M---tt-----GGG---------------------------kk-tt-----k------------ggg-tt----------y----------------------------------------------gg-tt----------kk---#-
XXXXXXXXXXXXXXXXXXXXXXX-----XXXXXXXX---XXXXXXXXXXXXXXXXXXXX----XXXXXXXXXXXXXXXXXXXX-----XXXXXXXXXXXXXXX---XXXXXX-----XXXXXX----XXXXXXXXXXXXXXXXXXXXXXX
XXXXXXXXXXXXXXXXXXXXXXX-----XXXXXXXX---XXXXXXXXXXXXXXXXXXXX----XXXXXXXXXXXXXXXXXXXX-----XXXXXXXXXXXXXXX---XXXXXX-----XXXXXX----XXXXXXXXXXXXXXXXXXXXXXX
