------------------------------------------------------------------------------------------------------------------------------------------------------
------------------------------------------------------------------------------------------------------------------------------------------------------
------------------------------------------------------------------------------------------------------------------------------------------------------
------------------------------------------------------------------------------------------------------------------------------------------------------
------------------------------------------------------------------------------------------------------------------------------------------------------
------------------------------------------------------------------------------------------------------------------------------------------------------
-----------------------------------------------------------------------------------------------------!------------------------------------------------
------------------------------------------------------------------------------------------------------------------------------------------------------
------------------------------------------------------------------------------------------------------------------------------------------------------
--------------TT----------------------------------------------------------tt--------------------------------------------------------------------------
--------------TT----------------------------------------------------------tt---------------------tt---------------tt----------------------------------
--------------TT----------------------------------------------------------tt---------------------tt--LL-----------tt----------------tt----------------
--------------TT---------------------------------------tt-----------------tt---------------------tt---------------tt----------------tt--------------F-
-M------------TT----r----------------------------------tt--y------------k-tt-g-----------------rrtt-----kk--------tt----gg------GG--ttrr------------#-
XXXXXX----XXXXXXXXXXXX----XXXXXXXXXX---XXXXXXXX-----XXXXXXXXXXXXX-----XXXXXXXXXXXXXXXXXX-----XXXXXXXXXXXXX-----XXXXXXXXXXXXXX---XXXXXXXXXXXXXXXXXXXXXX
XXXXXX----XXXXXXXXXXXX----XXXXXXXXXX---XXXXXXXX-----XXXXXXXXXXXXX-----XXXXXXXXXXXXXXXXXX-----XXXXXXXXXXXXX-----XXXXXXXXXXXXXX---XXXXXXXXXXXXXXXXXXXXXX
