------------------------------------------------------------------------------------------------------------------------------------------------------
------------------------------------------------------------------------------------------------------------------------------------------------------
------------------------------------------------------------------------------------------------------------------------------------------------------
------------------------------------------------------------------------------------------------------------------------------------------------------
------------------------------------------------------------------------------------------------------------------------------------------------------
------------------------------------------------------------------------------------------------------------------------------------------------------
------------------------------------------------------------------------------------------------------------------------------------------------------
------------------------------------------------------------------------------------------------------------------------L-----------------------------
------------------------------------------------------------------------------------------------------------------------------------------------------
------------------------------------------------------------------------------------------------------------------tt----------------------------------
----------L-L-----------------------------------------------------------------------------------------------------tt----------------------------------
------------------------------tt-U-U------------------------------------------------------------------------------tt----UU----------------------------
-----tt-----------------------tt----------------------------------------------------------------------------------tt--------------------------------F-
-M---tt--yyy-------------r----tt-----ggg----------------------------------------------------------------------ggg-tt------------yyy-----------------#-
XXXXXXXXXXXXXXXXXXXX-----XXXXXXXXXXXXXXXXX-----XXXXXXXXXXXXXX-----XXXXXXXXXX-----XXXXXXXX-----XXXXXXXXXX---XXXXXXXXXXXXXXXXXXXXXX-----XXXXXXX----XXXXX
XXXXXXXXXXXXXXXXXXXX-----XXXXXXXXXXXXXXXXX-----XXXXXXXXXXXXXX-----XXXXXXXXXX-----XXXXXXXX-----XXXXXXXXXX---XXXXXXXXXXXXXXXXXXXXXX-----XXXXXXX----XXXXX
