------------------------------------------------------------------------------------------------------------------------------------------------------
------------------------------------------------------------------------------------------------------------------------------------------------------
------------------------------------------------------------------------------------------------------------------------------------------------------
------------------------------------------------------------------------------------------------------------------------------------------------------
------------------------------------------------------------------------------------------------------------------------------------------------------
------------------------------------------------------------------------------------------------------------------------------------------------------
------------------------------------------------------------------------------------------------------------------------------------------------------
------------------------------------------------------------------------------------------------------------------------------------------------------
------------------------------------------------------------------------------------------------------------------------------------------------------
----------------------------------------------------------------------------SS----------tt----------------tt------------------------------------------
--------------------tt------------------------------------------------------------------tt----------------tt------------------------------------------
--------------------tt------------------------------------------------------------------tt--SS------------tt------------------------------------------
----tt--------------tt--------------------------------------------------tt--------------tt----------------tt----------------------------------------F-
-M--tt--g-------ggg-tt-----------------------yyy-------------------rr---tt-----g--------tt-----y------kk--tt-kkk------------------------------------#-
XXXXXXXXXXX----XXXXXXXXXXXXXXXXXXXXXXXXXXXXXXXXXX---XXXXXXXXX-----XXXXXXXXXXXXXXXX---XXXXXXXXXXXXX----XXXXXXXXXXXXX-----XXXXXXXXXXXXXXXXX----XXXXXXXXX
XXXXXXXXXXX----XXXXXXXXXXXXXXXXXXXXXXXXXXXXXXXXXX---XXXXXXXXX-----XXXXXXXXXXXXXXXX---XXXXXXXXXXXXX----XXXXXXXXXXXXX-----XXXXXXXXXXXXXXXXX----XXXXXXXXX
