------------------------------------------------------------------------------------------------------------------------------------------------------
------------------------------------------------------------------------------------------------------------------------------------------------------
------------------------------------------------------------------------------------------------------------------------------------------------------
------------------------------------------------------------------------------------------------------------------------------------------------------
------------------------------------------------------------------------------------------------------------------------------------------------------
------------------------------------------------------------------------------------------------------------------------------------------------------
------------------------------------------------------------------------------------------------------------------------------------------------------
------------------------------------------------------------------------------------------------------------------------------------------------------
------------------------------------------------------------------------------------------------------------------------------------------------------
------------------------------------------------------------------------------------------tt----------------------------------------------------------
---------------------tt----UU-------------------------------------------------------------tt---------------------------------------------tt-----------
-----TT--------------tt-------------------------------------------------------------------tt---------------------------------------------tt-----------
-----TT--------------tt-------------------------------------------------------------------tt---------------------------------------------tt---------F-
-M---TT--rr-----gg---tt-----r-----------------------------------------------------------RRtt-yy---------------------------------------yy-tt----g----#-
XXXXXXXXXXXXX---XXXXXXXXXXXXXXXXXXXX-----XXXX-----XXXXXXXXXXXXXXXXXXXXXXXXXXXXXXXX----XXXXXXXXXXX----XXXXXXXX-----XXXXXXXXXXXXXX-----XXXXXXXXXXXXXXXXX
XXXXXXXXXXXXX---XXXXXXXXXXXXXXXXXXXX-----XXXX-----XXXXXXXXXXXXXXXXXXXXXXXXXXXXXXXX----XXXXXXXXXXX----XXXXXXXX-----XXXXXXXXXXXXXX-----XXXXXXXXXXXXXXXXX
