------------------------------------------------------------------------------------------------------------------------------------------------------
------------------------------------------------------------------------------------------------------------------------------------------------------
------------------------------------------------------------------------------------------------------------------------------------------------------
------------------------------------------------------------------------------------------------------------------------------------------------------
------------------------------------------------------------------------------------------------------------------------------------------------------
------------------------------------------------------------------------------------------------------------------------------------------------------
------------------------------------------------------------------------------------------------------------------------------------------------------
------------------------------------------------------------------------------------------------------------------------------------------------------
------------------------------------------------------------------------------------------------------------------------------------------------------
--------------------------------------------------------------------------------------------------------------------------------------k---------------
-----------------------------------------------------------------------------------------------------------------------------------L@-@L--------------
------------------------------------------------------------------------------------------------------------------------------TT----------------------
-----------------tt-----------------------------tt----------------------------------------------------------------------------TT--------------------F-
-M---------------tt--------RRR------------------tt--yyy-----------------------------------------------------------------gg----TT------------kk------#-
XXXXXX----XXXXXXXXXXXXXXXXXXXX----XXXXXX-----XXXXXXXXXXXXXXXX----XXXXXXXXXXXXXXXXXXXXXXX-----XXXXXXXXXXXX---XXXXXXXXX---XXXXXXXXXXXXXXXXXXXXXXX--XXXXX
XXXXXX----XXXXXXXXXXXXXXXXXXXX----XXXXXX-----XXXXXXXXXXXXXXXX----XXXXXXXXXXXXXXXXXXXXXXX-----XXXXXXXXXXXX---XXXXXXXXX---XXXXXXXXXXXXXXXXXXXXXXX--XXXXX
