------------------------------------------------------------------------------------------------------------------------------------------------------
------------------------------------------------------------------------------------------------------------------------------------------------------
------------------------------------------------------------------------------------------------------------------------------------------------------
------------------------------------------------------------------------------------------------------------------------------------------------------
------------------------------------------------------------------------------------------------------------------------------------------------------
------------------------------------------------------------------------------------------------------------------------------------------------------
------------------------------------------------------------------------------------------------------------------------------------------------------
------------------------------------------------------------------------------------------------------------------------------------------------------
------------------------------------------------------------------------------------------------------------------------------------------------------
------------------------------------------------------------------------------------------------------------------------------------------L-L---------
-------------------------tt---------------------------------tt--------------------------------TT-------------------------------------tt---------------
-------------------------tt---------------------------------tt--------------------------------TT-------------------------------------tt---------------
-------------------------tt---------------------------------tt--------------------------------TT-------------------------------------tt-------------F-
-M-----------------------tt--------RR-----------------------tt---------------------kk------gg-TT----kk-----------------------------yytt--r----------#-
XXXXXX---XXXXXXXX-----XXXXXXXXXXXXXXXX-----XXXXXXXXXX----XXXXXXXXXXXXXXXXXXXXXXXXXXX-----XXXXXXXXXXXXXX---XXXXXXX-----XXXXXX----XXXXXXXXXXXXXXXXXXXXXX
XXXXXX---XXXXXXXX-----XXXXXXXXXXXXXXXX-----XXXXXXXXXX----XXXXXXXXXXXXXXXXXXXXXXXXXXX-----XXXXXXXXXXXXXX---XXXXXXX-----XXXXXX----XXXXXXXXXXXXXXXXXXXXXX
