------------------------------------------------------------------------------------------------------------------------------------------------------
------------------------------------------------------------------------------------------------------------------------------------------------------
------------------------------------------------------------------------------------------------------------------------------------------------------
------------------------------------------------------------------------------------------------------------------------------------------------------
------------------------------------------------------------------------------------------------------------------------------------------------------
------------------------------------------------------------------------------------------------------------------------------------------------------
------------------------------------------------------------------------------------------------------------------------------------------------------
--------------------------------------------------------------------------------!---------------------------------------------------------------------
------------------------------------------------------------------------------------------------------------------------------------------------------
----------------------gg------------------------------------------------------------------------------------------------------tt--CSSC----------------
-----------------tt-U@-@U--------------------------------------------------tt-------------------------------------------------tt----------------------
-----------------tt--------------------------------------------------------tt---SS---------------------tt---------------------tt----------------------
-----------------tt--------------------------------------------------------tt--------------------------tt---------------------tt--------------------F-
-M---------------tt--------------------r--------------------------------gg-tt--------rr----------------tt--------rr-----------tt---rrr--------------#-
XXXXXXXXX---XXXXXXXXXXXXXXXXXXXXXXXXXXXXXXX---XXXXXXXXXX---XXXXXX----XXXXXXXXXXXXXXXXXXXXXXXXXXXX---XXXXXXXXXXXXXXXXXXX----XXXXXXXXXXXXXXXXXXXX--XXXXX
XXXXXXXXX---XXXXXXXXXXXXXXXXXXXXXXXXXXXXXXX---XXXXXXXXXX---XXXXXX----XXXXXXXXXXXXXXXXXXXXXXXXXXXX---XXXXXXXXXXXXXXXXXXX----XXXXXXXXXXXXXXXXXXXX--XXXXX
