------------------------------------------------------------------------------------------------------------------------------------------------------
------------------------------------------------------------------------------------------------------------------------------------------------------
------------------------------------------------------------------------------------------------------------------------------------------------------
------------------------------------------------------------------------------------------------------------------------------------------------------
------------------------------------------------------------------------------------------------------------------------------------------------------
------------------------------------------------------------------------------------------------------------------------------------------------------
------------------------------------------------------------------------------------------------------------------------------------------------------
------------------------------------------------------------------------------------------------------------------------------------------------------
------------------------------------------------------------------------------------------------------------------------------------------------------
---------------------------------------------------r----------------------------------------------------------------------------------------tt--------
-------------------------------TT-----------------!!-!!-------------------------------------------------------------------------------------tt--------
-------------------------------TT-----------TT----------------------------------------------------------------------------------------------tt-SS-----
-------------------------------TT-----------TT----------------------------------------------------------------------------------------------tt------F-
-M-----------------------------TT-rrr-------TT----------y---------------------------------------------------------------------------------ggtt--KKK-#-
XXXXXXXXXXXXX----XXXXXX----XXXXXXXXXXX---XXXXXXXXXXXXXXXXXXXX----XXXXXXXXXXXXXXXXXXXXXXXXXXXXXXXX---XXXXXXXXX-----XXXXXX---XXXXXXXX----XXXXXXXXXXXXXXX
XXXXXXXXXXXXX----XXXXXX----XXXXXXXXXXX---XXXXXXXXXXXXXXXXXXXX----XXXXXXXXXXXXXXXXXXXXXXXXXXXXXXXX---XXXXXXXXX-----XXXXXX---XXXXXXXX----XXXXXXXXXXXXXXX
